District code,State name,District name,lat,long,Population,Male,Rural_Households,Urban_Households,Female,Literate,Male_Literate,Female_Literate,Workers,Illiterate_Education,Housholds_with_Electric_Lighting,Male_Workers,Female_Workers,Households_with_Internet,Households_with_Computer,Households_with_Television,Power_Parity_Less_than_Rs_45000,Power_Parity_Rs_45000_90000,Power_Parity_Rs_90000_150000,Power_Parity_Rs_45000_150000,Power_Parity_Rs_150000_240000,Power_Parity_Rs_240000_330000,Power_Parity_Rs_150000_330000,Power_Parity_Rs_330000_425000,Power_Parity_Rs_425000_545000,Power_Parity_Rs_330000_545000,Power_Parity_Above_Rs_545000,Total_Power_Parity,sex_ratio,literacy_rate
4,JAMMU AND KASHMIR,Kargil,33.565994894894914,76.63675315315312,140802,77785,40370,7774,63017,86236,56301,29935,51873,39854,15824,39839,12034,235,1005,8008,39,87,27,114,12,18,30,19,3,22,7,214,123.0,61.0
5,JAMMU AND KASHMIR,Punch,33.791241290322574,74.29593161290322,476835,251899,132139,15269,224936,261724,163333,98391,161393,164044,62900,117677,43716,346,3342,16022,117,268,78,346,35,50,85,59,8,67,12,629,112.0,55.0
7,JAMMU AND KASHMIR,Kathua,32.51781678321678,75.58901398601404,616435,326109,181374,33473,290326,389204,228499,160705,200431,181297,109422,161548,38883,1443,6112,66944,139,340,174,514,54,69,123,78,52,130,28,936,112.0,63.0
10,JAMMU AND KASHMIR,Srinagar,34.27312898550724,75.11021159420288,1236829,651124,4518,257721,585705,748584,431746,316838,407188,310225,165403,333151,74037,16413,33831,152945,251,427,668,1095,319,380,699,240,370,610,445,3099,111.0,61.0
12,JAMMU AND KASHMIR,Pulwama,33.88414418604652,75.00921860465118,560440,293064,147520,21703,267376,293958,178326,115632,188420,190369,73629,138428,49992,1537,5293,45967,213,430,119,549,71,96,167,84,24,108,32,1068,110.0,52.0
16,JAMMU AND KASHMIR,Doda,33.359614675767915,76.07163720136518,409936,213641,122267,11350,196295,219083,138620,80463,151912,163565,61831,101144,50768,596,3077,19244,247,467,99,566,75,102,177,74,19,93,19,1103,109.0,53.0
19,JAMMU AND KASHMIR,Udhampur,33.04770670731707,75.15286951219511,554985,296784,148664,34696,258201,322354,197543,124811,243672,194838,73999,163845,79827,1214,5744,37323,218,492,171,663,87,107,194,122,43,165,37,1278,115.0,58.0
21,JAMMU AND KASHMIR,Jammu,32.713199095022645,74.8477520361991,1529958,813821,254566,248043,716137,1137135,641916,495219,508622,268279,294739,417456,91166,19905,46657,240478,404,827,682,1509,281,382,663,282,271,553,398,3525,114.0,74.0
23,HIMACHAL PRADESH,Chamba,32.66741814595661,76.39354063116366,519080,261320,186395,13836,257760,323842,186064,137778,294035,154575,96082,158791,135244,1615,5117,62233,118,276,222,498,72,38,110,49,79,128,97,950,101.0,62.0
24,HIMACHAL PRADESH,Kangra,32.14093603238864,76.41205910931173,1510075,750591,588321,39007,759484,1152640,606443,546197,675170,271892,330081,403756,271414,8053,22753,272579,317,800,706,1506,252,101,353,127,206,333,369,2878,99.0,76.0
26,HIMACHAL PRADESH,Kullu,31.90911922077925,77.40922649350647,437903,225452,167995,20709,212451,307672,174550,133122,269084,103136,91322,148829,120255,2623,7010,66910,98,239,205,444,70,35,105,41,67,108,100,854,106.0,70.0
27,HIMACHAL PRADESH,Mandi,31.635805940594054,76.96556930693067,999777,498065,431129,31696,501712,723747,393669,330078,572671,218570,214491,297464,275207,5333,16401,157314,233,535,431,966,131,77,208,93,152,245,190,1842,99.0,72.0
28,HIMACHAL PRADESH,Hamirpur,31.67668481012659,76.49767088607594,454768,217070,196116,15232,237698,358091,180555,177536,241931,72551,104120,118724,123207,2521,7525,86324,95,240,215,455,77,34,111,40,64,104,113,878,91.0,79.0
28,HIMACHAL PRADESH,Hamirpur,25.73815838150289,79.82619479768789,454768,217070,196116,15232,237698,358091,180555,177536,241931,72551,104120,118724,123207,2521,7525,86324,95,240,215,455,77,34,111,40,64,104,113,878,91.0,79.0
168,UTTAR PRADESH,Hamirpur,31.67668481012659,76.49767088607594,1104285,593537,256081,55300,510748,653299,408125,245174,443655,364848,55929,308527,135128,1196,11037,48564,240,488,250,738,91,123,214,40,33,73,26,1291,116.0,59.0
168,UTTAR PRADESH,Hamirpur,25.73815838150289,79.82619479768789,1104285,593537,256081,55300,510748,653299,408125,245174,443655,364848,55929,308527,135128,1196,11037,48564,240,488,250,738,91,123,214,40,33,73,26,1291,116.0,59.0
29,HIMACHAL PRADESH,Una,31.58330388349513,76.18353932038836,521173,263692,185091,20126,257481,399715,213281,186434,215346,87735,105929,141612,73734,2412,8238,88894,108,271,240,511,87,38,125,46,75,121,122,987,102.0,77.0
30,HIMACHAL PRADESH,Bilaspur,22.356942982456143,81.99770350877188,381956,192764,152458,11987,189192,287620,155599,132021,205871,65864,79146,111543,94328,1574,6281,61392,528,1214,671,1885,271,221,492,315,374,689,72,3666,102.0,75.0
30,HIMACHAL PRADESH,Bilaspur,31.3780422907489,76.65316079295157,381956,192764,152458,11987,189192,287620,155599,132021,205871,65864,79146,111543,94328,1574,6281,61392,528,1214,671,1885,271,221,492,315,374,689,72,3666,102.0,75.0
406,CHHATTISGARH,Bilaspur,22.356942982456143,81.99770350877188,2663629,1351574,549632,188174,1312055,1596560,932474,664086,1203197,943112,519704,715467,487730,8566,30892,193337,477,952,870,1822,232,82,314,75,99,174,195,2981,103.0,60.0
406,CHHATTISGARH,Bilaspur,31.3780422907489,76.65316079295157,2663629,1351574,549632,188174,1312055,1596560,932474,664086,1203197,943112,519704,715467,487730,8566,30892,193337,477,952,870,1822,232,82,314,75,99,174,195,2981,103.0,60.0
31,HIMACHAL PRADESH,Solan,31.03864311926604,76.94442140672783,580320,308754,192787,51509,271566,428578,244372,184206,298737,104084,119866,190001,108736,5250,14478,94692,116,317,307,624,130,58,188,63,103,166,160,1253,114.0,74.0
32,HIMACHAL PRADESH,Sirmaur,30.682764453961443,77.43184689507493,529855,276289,171102,21054,253566,362645,205617,157028,280083,140486,91509,169399,110684,2220,8593,58902,124,274,209,483,61,44,105,53,87,140,77,930,109.0,68.0
33,HIMACHAL PRADESH,Shimla,31.155725451807253,77.62573042168668,814010,425039,279269,95896,388971,612642,342846,269796,430926,137576,172754,258628,172298,9177,24127,131450,156,397,415,812,150,104,254,82,133,215,232,1668,109.0,75.0
34,HIMACHAL PRADESH,Kinnaur,31.60667184065933,78.51613736263741,84121,46249,44514,0,37872,60699,36697,24002,56273,16944,17865,33863,22410,354,2563,12925,21,52,44,96,15,6,21,8,13,21,23,181,122.0,72.0
35,PUNJAB,Gurdaspur,32.04283371212125,75.3204064393939,2298323,1212617,420860,185488,1085706,1634719,907660,727059,757138,478020,411216,637652,119486,14428,38445,365644,269,1023,1250,2273,830,459,1289,575,897,1472,678,5982,112.0,71.0
36,PUNJAB,Kapurthala,31.33659263803684,75.47641165644177,815168,426311,165433,95770,388857,576567,316254,260313,284165,174995,161206,235562,48603,9732,23145,144945,81,322,555,877,298,228,526,223,293,516,470,2472,110.0,71.0
37,PUNJAB,Jalandhar,31.250336907216507,75.54400350515463,2193590,1145211,330339,377791,1048379,1622537,882581,739956,774472,387809,446200,639484,134988,39082,79134,401189,201,803,1594,2397,755,677,1432,655,800,1455,1399,6883,109.0,74.0
38,PUNJAB,Hoshiarpur,31.55157169811319,75.8469857442349,1586625,809057,422673,128592,777568,1199699,637927,561772,499822,294723,319930,412506,87316,13747,34328,285904,167,653,925,1578,586,357,943,360,529,889,730,4305,104.0,76.0
40,PUNJAB,Fatehgarh Sahib,30.64290947368421,76.36208394736842,600163,320795,117559,57337,279368,426033,238696,187337,214783,142314,113683,182777,32006,5138,14294,98080,67,263,355,618,217,132,349,153,232,385,222,1640,115.0,71.0
41,PUNJAB,Ludhiana,30.76596397379912,75.83110851528383,3498739,1867816,395032,641789,1630923,2560225,1428348,1131877,1284822,631980,703624,1053600,231222,58589,123400,604959,336,1382,2526,3908,1039,1014,2053,1116,1457,2573,1722,10593,115.0,73.0
42,PUNJAB,Moga,30.756540067340065,75.1600845117845,995746,525920,214295,74144,469826,627889,348549,279340,359172,306336,183396,292379,66793,7897,21662,152610,128,479,574,1053,401,196,597,256,403,659,336,2774,112.0,63.0
43,PUNJAB,Firozpur,30.63407535211269,74.40245732394365,2029074,1071637,348522,153868,957437,1227511,707070,520441,756695,714869,349662,596406,160289,10042,31070,277615,235,838,818,1656,582,373,955,479,747,1226,212,4283,112.0,60.0
44,PUNJAB,Muktsar,30.31243303303303,74.5518747747748,901896,475622,149507,74650,426274,524848,300401,224447,335326,340886,166585,272699,62627,4571,14077,130482,113,402,382,784,280,173,453,226,354,580,95,2025,112.0,58.0
45,PUNJAB,Faridkot,30.591187250996025,74.79751553784862,617508,326671,99946,58917,290837,381285,215767,165518,221555,204895,113549,185049,36506,4348,12276,93053,76,276,313,589,199,133,332,168,254,422,122,1540,112.0,62.0
46,PUNJAB,Bathinda,30.190524611973352,75.05685898004438,1388525,743197,218159,137563,645328,844868,488261,356607,549986,438529,255650,432988,116998,11284,32253,204051,160,592,692,1284,439,284,723,356,542,898,302,3365,115.0,61.0
47,PUNJAB,Mansa,29.919547714285724,75.4304922857143,769751,408732,145603,50786,361019,423560,244037,179523,328512,311513,140099,230739,97773,2673,10085,102314,106,366,294,660,236,155,391,202,279,481,56,1694,113.0,55.0
48,PUNJAB,Patiala,30.214540380693364,76.27505893949697,1895686,1002522,299279,218090,893164,1266791,711052,555739,660267,518772,352929,549661,110606,24274,55105,308440,241,905,1235,2140,694,464,1158,597,857,1454,687,5679,112.0,67.0
49,PUNJAB,Amritsar,31.54867982062777,74.79883856502238,2490656,1318408,275477,385476,1172248,1684770,932981,751789,917856,540010,461231,735195,182661,29961,63864,413460,262,1025,1582,2607,823,576,1399,709,990,1699,1012,6979,112.0,68.0
51,PUNJAB,Rupnagar,30.910937330754347,76.53743500967126,684627,357485,148162,60537,327142,502731,278534,224197,233676,124100,129123,186910,46766,6600,17542,111937,90,342,429,771,287,148,435,190,293,483,256,2034,109.0,73.0
53,PUNJAB,Sangrur,30.18504520433689,75.89437014178496,1655169,878029,292156,156788,777140,1002077,570413,431664,568758,570103,305557,485129,83629,10736,30955,244837,190,702,802,1504,542,314,856,398,621,1019,372,3943,113.0,61.0
55,CHANDIGARH,Chandigarh,30.7426,76.75872465753424,1055450,580663,8911,289456,474787,805438,465346,340092,404136,184265,231204,328159,75977,44283,78113,193932,893,3631,7152,10783,4285,2444,6729,3382,4461,7843,7897,34145,122.0,76.0
56,UTTARAKHAND,Uttarkashi,30.968958552036234,78.56880615384617,330086,168597,112148,9061,161489,215126,128237,86889,157276,83896,52621,84265,73011,602,4104,29400,73,133,66,199,23,32,55,19,4,23,5,356,104.0,65.0
57,UTTARAKHAND,Chamoli,30.58338611464965,79.56281095541402,391605,193991,163434,22906,197614,280556,155395,125161,180940,61950,71524,93832,87108,899,5582,46579,78,158,115,273,26,35,61,39,9,48,8,467,98.0,72.0
59,UTTARAKHAND,Tehri Garhwal,30.463700918635173,78.48783792650917,618931,297986,227059,27177,320945,407994,227406,180588,280442,133013,117239,140821,139621,1366,7831,68294,129,255,178,433,41,57,98,61,11,72,10,743,93.0,66.0
62,UTTARAKHAND,Pithoragarh,30.14720631868129,80.34229230769236,483439,239306,183687,26256,244133,345550,189623,155927,216490,88036,95421,113539,102951,1344,7932,58954,105,217,149,366,38,47,85,51,15,66,8,631,98.0,71.0
63,UTTARAKHAND,Bageshwar,29.98703393393397,79.83954354354357,259898,124326,96031,3880,135572,179483,97546,81937,123638,49539,47083,58708,64930,435,3595,25873,53,99,68,167,15,21,36,26,0,26,0,281,92.0,69.0
64,UTTARAKHAND,Almora,29.683532133676103,79.50165064267351,622506,291081,260056,21082,331425,436497,231604,204893,298211,109556,109876,142460,155751,1830,9858,70237,131,256,178,434,42,58,100,59,9,68,11,742,88.0,70.0
65,UTTARAKHAND,Champawat,29.29142393939393,80.07720212121217,259648,131125,85202,12839,128523,177726,102015,75711,99566,62429,37725,60427,39139,548,3159,22588,52,108,73,181,19,21,40,28,9,37,0,309,102.0,68.0
67,UTTARAKHAND,Udham Singh Nagar,29.02779577677222,79.45629004524895,1648902,858783,269406,145253,790119,1037839,598525,439314,591458,438598,254802,444578,146880,7883,28053,192243,280,619,399,1018,120,141,261,114,78,192,53,1805,109.0,63.0
69,HARYANA,Panchkula,30.700897142857134,76.97173238095236,561293,299679,70895,93656,261614,405318,229862,175456,211479,119222,103455,164865,46614,18615,32174,88378,42,196,344,540,187,180,367,101,157,258,238,1445,115.0,72.0
70,HARYANA,Ambala,30.3503672316384,76.94970310734456,1128350,598703,175365,139891,529647,818025,461288,356737,372139,222031,199681,320120,52019,12899,32767,172034,100,491,622,1113,386,294,680,227,364,591,297,2781,113.0,72.0
72,HARYANA,Kurukshetra,30.05652659846548,76.78774680306903,964655,510976,203553,88268,453679,646893,370828,276065,336780,266638,171908,268556,68224,7356,21951,143316,83,416,448,864,319,203,522,183,295,478,190,2137,113.0,67.0
73,HARYANA,Kaithal,29.96068539094649,76.37698930041155,1074304,571003,231091,75696,503301,646529,385782,260747,373899,369869,187349,292696,81203,3724,15301,140195,100,491,364,855,333,185,518,212,324,536,34,2046,113.0,60.0
74,HARYANA,Karnal,29.703200647249204,76.87488025889972,1505324,797712,292682,135920,707612,978013,564516,413497,516062,429220,267223,411646,104416,11163,29253,215813,146,730,658,1388,530,304,834,318,511,829,168,3368,113.0,65.0
75,HARYANA,Panipat,29.34352134146342,76.92895914634147,1205437,646857,173502,153804,558580,786599,464136,322463,412318,296212,209965,328667,83651,10024,26719,162321,91,444,591,1035,357,278,635,217,349,566,231,2559,116.0,65.0
77,HARYANA,Jind,29.45149821958457,76.29598575667653,1334152,713006,278335,89665,621146,832758,502049,330709,523422,419624,222462,368277,155145,5263,23750,160742,131,650,472,1122,441,238,679,279,433,712,29,2674,115.0,62.0
78,HARYANA,Fatehabad,29.57298318584072,75.54608716814157,942011,495360,203020,55360,446651,557578,327471,230107,369083,344534,153301,263498,105585,3210,13142,107042,89,444,330,774,304,161,465,187,301,488,39,1854,111.0,59.0
79,HARYANA,Sirsa,29.63583446327684,74.90970480225988,1295189,682582,245476,93316,612607,782897,456968,325929,502003,412353,215527,369462,132541,6287,22706,150315,113,569,538,1107,435,228,663,252,405,657,140,2681,111.0,60.0
80,HARYANA,Hisar,29.23628731117825,75.84324682779452,1743931,931562,302013,154113,812369,1114311,670200,444111,691621,505251,285004,488321,203300,10132,33400,202588,167,828,690,1518,577,340,917,362,579,941,100,3642,115.0,64.0
81,HARYANA,Bhiwani,28.728868064516128,76.02110225806452,1634445,866672,357047,99235,767773,1069871,643158,426713,623006,459364,266244,430678,192328,5292,25236,176336,150,756,628,1384,549,278,827,321,516,837,149,3349,113.0,65.0
82,HARYANA,Rohtak,28.892517647058817,76.53123235294117,1061204,568479,175203,131739,492725,747582,436025,311557,345967,248795,193120,272646,73321,8482,27225,150160,77,372,537,909,296,265,561,177,284,461,291,2299,115.0,70.0
83,HARYANA,Jhajjar,28.59651868131869,76.61137142857145,958405,514667,211816,78328,443738,676091,399480,276611,326534,201028,168558,250020,76514,5034,19241,128007,81,407,452,859,305,219,524,171,275,446,260,2169,116.0,71.0
84,HARYANA,Mahendragarh,28.1352161458333,76.14018072916659,922088,486665,223726,44216,435423,630255,380440,249815,338584,245602,135455,232935,105649,2624,13908,88012,80,407,363,770,303,157,460,169,270,439,144,1894,112.0,68.0
85,HARYANA,Rewari,28.19164714828897,76.55956007604564,900332,474335,199449,69305,425997,636947,375453,261494,337727,206827,152651,235326,102401,5121,18092,108753,72,359,421,780,270,208,478,153,247,400,249,1979,111.0,71.0
86,HARYANA,Gurgaon,28.043894789579163,77.01935130260523,1514432,816690,141703,381988,697742,1111116,638666,472450,544716,263720,305751,432456,112260,67087,102343,248024,85,404,714,1118,409,386,795,220,311,531,577,3107,117.0,73.0
88,HARYANA,Faridabad,28.14873109756098,77.32718536585368,1809733,966110,87700,382981,843623,1272739,734940,537799,579229,346567,333171,476933,102296,43437,82673,279652,156,729,1321,2050,638,640,1278,416,670,1086,511,5080,115.0,70.0
93,NCT OF DELHI,East,27.29600352941175,88.74908392156858,1709346,907500,1086,461132,801846,1352998,748382,604616,579692,169693,352758,486951,92741,80037,127465,320151,578,1681,1903,3584,589,582,1171,482,567,1049,769,7151,113.0,79.0
99,RAJASTHAN,Ganganagar,29.256785412667963,73.56192303262948,1969168,1043340,397697,164897,925828,1193343,710908,482435,912672,710223,283142,596320,316352,6295,24901,181616,327,997,958,1955,168,148,316,157,254,411,322,3332,113.0,61.0
100,RAJASTHAN,Hanumangarh,29.1813351791531,74.74632573289902,1774692,931184,389059,108694,843508,1034136,624281,409855,835260,723454,243163,512802,322458,3360,16217,140280,287,840,759,1599,123,114,237,133,215,348,239,2709,110.0,58.0
101,RAJASTHAN,Bikaner,28.12489068322981,73.26943322981371,2363937,1240801,335754,196179,1123136,1278801,782399,496402,986208,1015331,220793,640572,345636,7607,29531,138480,320,1004,995,1999,178,159,337,160,260,420,335,3411,110.0,54.0
102,RAJASTHAN,Churu,28.29330375536484,74.65846427038629,2039547,1051446,344897,148996,988101,1149269,696729,452540,902829,910226,231696,541404,361425,2577,15259,131174,373,1056,931,1987,139,157,296,178,289,467,238,3361,106.0,56.0
103,RAJASTHAN,Jhunjhunun,28.13517401247401,75.52840893970894,2137045,1095896,500452,150357,1041149,1370360,815834,554526,894649,712584,297559,541392,353257,4828,24178,189511,354,1021,945,1966,122,144,266,162,264,426,288,3300,105.0,64.0
104,RAJASTHAN,Alwar,27.55271738035265,76.65359630562563,3674179,1939026,782294,212967,1735153,2182476,1359829,822647,1708542,1384905,485723,994171,714371,9750,45770,258862,544,1700,1542,3242,447,209,656,241,390,631,661,5732,112.0,59.0
105,RAJASTHAN,Bharatpur,27.32411858037578,77.21752077244258,2548462,1355726,479437,129697,1192736,1480869,943910,536959,1071154,1104824,288723,647198,423956,4179,26106,160190,408,1161,1046,2207,132,158,290,185,301,486,308,3699,114.0,58.0
106,RAJASTHAN,Dhaulpur,26.72397054945053,77.74476219780222,1206516,653647,214670,58626,552869,683098,435721,247377,523212,552106,96086,339110,184102,1330,9504,51423,216,547,414,961,66,78,144,97,157,254,68,1641,118.0,57.0
107,RAJASTHAN,Karauli,26.51901555555556,76.96081818181815,1458248,783639,305047,59308,674609,805849,531904,273945,628726,668926,132079,371058,257668,1059,13045,49752,226,633,552,1185,72,81,153,99,161,260,164,1987,116.0,55.0
108,RAJASTHAN,Sawai Madhopur,26.251081180223288,76.4219283891548,1335551,704031,282057,71264,631520,741748,486184,255564,578068,586492,140947,343802,234266,1887,14310,61935,204,593,533,1126,81,80,161,94,152,246,164,1900,111.0,56.0
109,RAJASTHAN,Dausa,26.91234817629181,76.57342097264443,1634409,857787,361084,59610,776622,938051,596935,341116,684495,681980,195277,398151,286344,1719,14539,82113,286,745,612,1357,74,98,172,122,198,320,151,2286,110.0,57.0
110,RAJASTHAN,Jaipur,27.033459290187885,75.77117286012533,6626178,3468507,754841,977838,3157671,4300965,2554793,1746172,2464893,2046038,990085,1714947,749946,76565,182350,764302,890,3164,3578,6742,1130,645,1775,509,827,1336,1476,12219,110.0,65.0
111,RAJASTHAN,Sikar,27.64644058641976,75.29317422839503,2677333,1374990,527560,178274,1302343,1652117,995275,656842,1006504,967497,339457,657854,348650,5647,28382,218772,430,1247,1144,2391,166,173,339,197,319,516,359,4033,106.0,62.0
112,RAJASTHAN,Nagaur,27.07862016048146,74.14215667001012,3307743,1696325,675712,166489,1611418,1758624,1102750,655874,1425882,1533137,347344,857031,568851,4449,35328,184518,557,1555,1344,2899,176,205,381,250,407,657,371,4863,105.0,53.0
113,RAJASTHAN,Jodhpur,26.678460838536967,73.00450847457628,3687165,1923928,584215,307442,1763237,2031532,1265753,765779,1489741,1591957,408808,965103,524638,19335,54808,246002,540,1671,1676,3347,285,272,557,269,437,706,556,5708,109.0,55.0
114,RAJASTHAN,Jaisalmer,26.86900838548185,71.18371877346682,669919,361708,159117,30830,308211,308653,210415,98238,288903,397649,43141,182565,106338,754,7416,19388,110,309,278,587,36,41,77,49,79,128,86,986,117.0,46.0
115,RAJASTHAN,Barmer,25.77070908045978,71.50297126436782,2603751,1369022,542825,55980,1234729,1188322,783461,404861,1202482,1501858,126494,696240,506242,2766,37730,52926,426,1121,931,2052,103,136,239,176,285,461,259,3437,111.0,46.0
116,RAJASTHAN,Jalor,25.07578093797277,72.18647261724662,1828730,936634,419216,48202,892096,829582,543923,285659,896644,1033534,161845,494906,401738,1585,12794,54245,287,790,678,1468,92,94,186,120,194,314,217,2470,105.0,45.0
117,RAJASTHAN,Sirohi,24.7976905263158,72.75309131578943,1036346,534231,238535,69639,502115,476806,309900,166906,419829,577092,134089,272196,147633,2146,10297,65197,157,481,442,923,117,63,180,70,113,183,180,1621,106.0,46.0
118,RAJASTHAN,Pali,25.80490393541874,73.55285640766907,2037573,1025422,512909,139808,1012151,1085693,667381,418312,842327,983050,326793,523077,319250,4043,19270,154761,321,997,906,1903,227,130,357,149,242,391,345,3317,101.0,53.0
119,RAJASTHAN,Ajmer,26.199300378787903,74.6990419191919,2583052,1324085,409335,274919,1258967,1526673,926268,600405,1053722,1034334,393498,686149,367573,13499,41732,250461,372,1227,1280,2507,273,211,484,197,319,516,460,4339,105.0,59.0
120,RAJASTHAN,Tonk,26.153935071707927,75.79192216427637,1421326,728136,298911,81755,693190,749659,478329,271330,649161,661902,158264,371848,277313,1908,12482,83447,227,668,593,1261,104,89,193,105,171,276,187,2145,105.0,53.0
121,RAJASTHAN,Bundi,25.48580716049379,75.79984074074079,1110906,577160,239836,63452,533746,585044,371705,213339,526091,553622,136969,314806,211285,1392,7705,78692,178,532,470,1002,99,68,167,81,132,213,162,1723,108.0,53.0
122,RAJASTHAN,Bhilwara,25.45119767759564,74.63947595628417,2408523,1220736,530015,145865,1187787,1256126,777582,478544,1148165,1180456,373644,674589,473576,6207,24014,175393,369,1117,1033,2150,208,152,360,171,278,449,367,3694,103.0,52.0
123,RAJASTHAN,Rajsamand,25.24894767441859,73.96570215946844,1156597,581339,304622,61054,575258,619139,383334,235805,550831,544517,193276,319534,231297,1989,9222,80267,176,543,488,1031,139,66,205,77,125,202,208,1821,101.0,54.0
124,RAJASTHAN,Dungarpur,23.75104807692308,73.84765641025645,1388552,696532,322816,31547,692020,681591,415820,265771,641515,764563,141275,346624,294891,1477,11742,46510,201,611,530,1141,165,68,233,84,136,220,236,2030,101.0,49.0
125,RAJASTHAN,Banswara,23.45364203296701,74.44246868131869,1797485,907754,390437,39407,889731,829343,513854,315489,916574,1040914,120603,482236,434338,2324,15062,48693,286,839,723,1562,187,94,281,118,192,310,296,2734,102.0,46.0
126,RAJASTHAN,Chittaurgarh,24.631623761665463,74.80010997846382,1544338,783171,366780,88873,761167,821825,514851,306974,802755,715545,268172,456632,346123,4941,16560,119801,319,973,888,1861,213,124,337,142,231,373,349,3238,103.0,53.0
127,RAJASTHAN,Kota,25.175718080000014,76.18618928000001,1951014,1021161,203454,311735,929853,1298345,765396,532949,748811,588142,339899,534650,214161,12843,36297,236764,254,924,1024,1948,244,174,418,152,247,399,375,3394,110.0,67.0
128,RAJASTHAN,Baran,24.98023243243244,76.86210651828291,1222755,633945,249184,69804,588810,693307,432607,260700,552583,545842,161310,329754,222829,1363,9491,88344,202,556,479,1035,63,74,137,91,146,237,129,1741,108.0,57.0
129,RAJASTHAN,Jhalawar,24.24725541474657,76.11242891705065,1411129,725143,298624,63763,685986,739792,466815,272977,685950,696680,220428,402825,283125,1750,9403,96225,234,630,539,1169,65,83,148,102,165,267,145,1962,106.0,52.0
130,RAJASTHAN,Udaipur,24.44076752136749,73.84029839743584,3068420,1566801,665449,182769,1501619,1582629,973444,609185,1365783,1528671,357846,835839,529944,14211,48517,180282,451,1432,1389,2821,472,196,668,205,332,537,623,5101,104.0,52.0
131,RAJASTHAN,Pratapgarh,25.86484273170732,81.93530048780492,867848,437744,209813,24269,430104,401515,250122,151393,481294,488621,71612,251691,229603,716,5961,37216,299,871,778,1649,151,114,265,134,217,351,265,2829,102.0,46.0
173,UTTAR PRADESH,Pratapgarh,25.86484273170732,81.93530048780492,3209141,1606085,711085,41701,1603056,1931559,1121381,810178,1066601,1059636,140538,704569,362032,5149,34400,135185,602,1281,948,2229,199,286,485,270,24,294,29,3639,100.0,60.0
132,UTTAR PRADESH,Saharanpur,30.03381165217392,77.59905147826095,3466382,1834106,605082,284156,1632276,2077108,1220114,856994,1037344,1279517,404499,911136,126208,9699,38816,294410,612,1375,974,2349,251,332,583,223,138,361,125,4029,112.0,60.0
133,UTTAR PRADESH,Muzaffarnagar,29.470507977736563,77.64017847866423,4143512,2193434,673746,296104,1950078,2417339,1448528,968811,1291644,1431537,368153,1081569,210075,10077,56149,331760,769,1699,1114,2813,316,416,732,234,173,407,149,4871,112.0,58.0
134,UTTAR PRADESH,Bijnor,29.313974259681096,78.45098815489754,3682713,1921215,683875,224648,1761498,2135393,1241471,893922,1088036,1308683,268353,921497,166539,7303,37341,260312,722,1551,930,2481,289,381,670,187,142,329,109,4310,109.0,58.0
135,UTTAR PRADESH,Moradabad,28.851770406189537,78.73580193423597,4772006,2503186,692398,355518,2268820,2263848,1357435,906413,1417811,2097292,281758,1193439,224372,11690,61846,283005,829,1875,1250,3125,357,464,821,253,226,479,198,5452,110.0,47.0
136,UTTAR PRADESH,Rampur,28.83244727272725,79.10977333333337,2335819,1223889,396775,143217,1111930,1043666,630408,413258,737261,1235413,131112,609693,127568,3847,25960,134249,461,965,474,1439,186,239,425,82,92,174,48,2545,110.0,45.0
137,UTTAR PRADESH,Jyotiba Phule Nagar,28.8704989847716,78.39009365482241,1840221,963449,335888,115486,876772,983110,600541,382569,599089,520215,89329,459037,140052,2825,18303,101804,340,749,449,1198,139,175,314,109,76,185,34,2074,110.0,53.0
138,UTTAR PRADESH,Meerut,29.02957625698323,77.80611005586593,3443689,1825743,381520,422303,1617946,2141488,1254520,886968,1090539,990312,425624,898810,191729,23717,69473,354359,563,1494,1364,2858,291,373,664,301,269,570,300,4953,113.0,62.0
139,UTTAR PRADESH,Baghpat,29.045793499999988,77.30266300000001,1303048,700070,246055,69991,602978,797970,489858,308112,416695,376700,119121,342604,74091,2989,19999,111663,264,551,317,868,102,139,241,57,44,101,39,1514,116.0,61.0
140,UTTAR PRADESH,Ghaziabad,28.74997308584685,77.67441879350343,4681645,2488834,355407,836316,2192811,3123264,1811397,1311867,1520538,885070,695130,1231615,288923,78116,179552,592753,552,1645,1787,3432,335,427,762,375,347,722,478,5946,113.0,67.0
141,UTTAR PRADESH,Gautam Buddha Nagar,28.39331103896104,77.52462467532465,1648115,890214,170835,338935,757901,1122947,666065,456882,569109,342284,257586,443384,125725,53181,87188,232925,222,649,750,1399,285,158,443,173,122,295,220,2578,117.0,68.0
142,UTTAR PRADESH,Bulandshahr,28.34875862068968,78.01082758620684,3499171,1845260,658449,221628,1653911,2031656,1253314,778342,1173260,1185318,223922,897815,275445,7865,38225,254050,719,1593,1020,2613,298,388,686,219,168,387,129,4534,112.0,58.0
143,UTTAR PRADESH,Aligarh,27.93748576850093,78.00146831119557,3673889,1951996,582117,275942,1721893,2092567,1283380,809187,1174361,1352181,268120,929337,245024,13634,58336,262098,636,1437,1037,2474,270,364,634,202,160,362,185,4290,113.0,57.0
145,UTTAR PRADESH,Mathura,27.59390432801821,77.62153416856502,2547184,1367125,407488,177802,1180059,1507746,943346,564400,840939,691359,281239,635142,205797,8726,37596,221574,429,994,775,1769,181,241,422,179,109,288,116,3025,116.0,59.0
146,UTTAR PRADESH,Agra,26.99512974910393,78.05278291517321,4418797,2364953,496971,406852,2053844,2680510,1614594,1065916,1389844,963202,536402,1119701,270143,27183,82012,433913,735,1846,1594,3440,359,471,830,326,298,624,354,5982,115.0,61.0
147,UTTAR PRADESH,Firozabad,27.20963993055552,78.42660624999998,2498156,1332046,349747,185621,1166110,1521806,912314,609492,761521,672115,196080,621840,139681,5834,31797,169583,490,1074,575,1649,213,269,482,96,136,232,88,2940,114.0,61.0
148,UTTAR PRADESH,Mainpuri,27.17386862302482,79.03501851015807,1868529,993377,338475,72783,875152,1203885,712110,491775,560840,519493,79022,466067,94773,2642,24451,76780,372,748,401,1149,137,189,326,66,44,110,43,1998,114.0,64.0
150,UTTAR PRADESH,Bareilly,28.51101940789474,79.43187072368416,4448359,2357665,631613,362798,2090694,2191759,1342697,849062,1401971,1744527,272830,1153006,248965,15164,56575,300504,807,1794,1114,2908,348,455,803,196,217,413,195,5126,113.0,49.0
151,UTTAR PRADESH,Pilibhit,28.52024175035868,79.90103974175037,2031007,1072002,371752,89638,959005,1061095,654290,406805,618605,977839,83006,534939,83666,2870,18097,106945,401,811,401,1212,151,203,354,64,56,120,37,2125,112.0,52.0
152,UTTAR PRADESH,Shahjahanpur,27.991389350649328,79.8302275324675,3006538,1606403,520289,134714,1400135,1490930,915142,575788,892214,1324615,115163,783313,108901,3889,27533,135885,600,1264,720,1984,233,309,542,146,102,248,69,3441,115.0,50.0
154,UTTAR PRADESH,Sitapur,27.501995963091108,80.85288881199547,4483992,2375264,827583,111319,2108728,2283733,1397702,886031,1422602,2141696,102040,1171252,251350,3874,34609,123246,888,1749,861,2610,316,440,756,136,81,217,65,4535,113.0,51.0
155,UTTAR PRADESH,Hardoi,27.337409090909137,80.26411767676768,4092845,2191442,786613,121064,1901403,2221601,1374587,847014,1318946,1481604,95508,1091952,226994,3845,32065,132969,818,1617,808,2425,292,406,698,132,76,208,61,4209,115.0,54.0
156,UTTAR PRADESH,Unnao,26.63163990895297,80.636773292868,3108367,1630087,596317,121039,1478280,1773584,1053063,720521,1124744,1130103,99466,851014,273730,3476,28719,134235,602,1283,852,2135,224,305,529,205,82,287,68,3620,110.0,57.0
157,UTTAR PRADESH,Lucknow,26.838233589251463,80.89706026871404,4589838,2394476,344155,717566,2195362,3127260,1742440,1384820,1542806,1146880,582769,1226399,316407,68506,152257,506413,603,1862,2204,4066,693,530,1223,431,396,827,767,7486,109.0,68.0
158,UTTAR PRADESH,Rae Bareli,26.253902840059787,81.22260463378181,3405559,1752542,705025,73393,1653017,1965843,1165965,799878,1204710,1286726,247856,867393,337317,5184,34788,130197,647,1350,933,2283,224,317,541,237,51,288,53,3812,106.0,58.0
159,UTTAR PRADESH,Farrukhabad,27.45063297872342,79.4406284574468,1885204,1006240,316647,94843,878964,1092677,654827,437850,592267,710960,88081,494545,97722,2624,18733,87314,359,751,425,1176,141,190,331,73,63,136,56,2058,114.0,58.0
160,UTTAR PRADESH,Kannauj,26.993988617886185,79.64437940379408,1656616,881776,299785,65985,774840,1017087,603596,413491,524676,543034,61491,430934,93742,2488,18082,64187,325,656,331,987,122,166,288,51,43,94,35,1730,114.0,61.0
161,UTTAR PRADESH,Etawah,26.78817670157068,79.07621806282728,1581810,845856,265643,85483,735954,1062003,623583,438420,506072,397708,113098,413713,92359,2964,21506,84543,290,636,417,1053,119,157,276,85,62,147,58,1825,115.0,67.0
162,UTTAR PRADESH,Auraiya,26.66892394014961,79.42637057356607,1379545,740040,255836,58438,639505,930836,546198,384638,442023,276224,65479,364543,77480,2404,14279,60174,259,549,338,887,97,129,226,83,36,119,20,1510,116.0,67.0
163,UTTAR PRADESH,Kanpur Dehat,26.43047641196011,79.98710083056478,1796184,963255,363933,41323,832929,1170243,692964,477279,628864,475166,49753,493991,134873,2682,25354,65556,343,724,527,1251,115,164,279,146,17,163,20,2056,116.0,65.0
165,UTTAR PRADESH,Jalaun,26.067954587155988,79.36686911314993,1689974,906092,304856,91565,783882,1075196,653430,421766,620764,461666,104176,470969,149795,2217,18615,90428,323,688,403,1091,129,173,302,72,63,135,55,1906,116.0,64.0
166,UTTAR PRADESH,Jhansi,25.45581535234902,78.89954580536917,1998603,1057436,309592,195321,941167,1304513,783705,520808,814914,483088,183340,565357,249557,8517,40774,163900,350,852,666,1518,166,214,380,138,131,269,135,2651,112.0,65.0
167,UTTAR PRADESH,Lalitpur,24.58877161016945,78.60082330508473,1221592,641011,258013,43819,580581,641191,397586,243605,503351,509536,77082,326783,176568,1079,9906,53524,239,483,260,743,87,120,207,47,28,75,22,1287,110.0,52.0
169,UTTAR PRADESH,Mahoba,25.34529670138888,79.67863003472216,875958,466358,198298,48525,409600,488106,302283,185823,349676,403649,42936,237153,112523,1316,11298,35422,161,338,176,514,64,85,149,31,30,61,20,904,114.0,56.0
170,UTTAR PRADESH,Banda,25.351885902503284,80.52487391304344,1799410,965876,378056,67569,833534,1002937,630626,372311,701689,588025,73522,485314,216375,1655,18612,52233,348,722,406,1128,130,175,305,84,49,133,32,1949,116.0,56.0
171,UTTAR PRADESH,Chitrakoot,25.159924623803,81.07666087551297,991730,527721,207237,23558,464009,531072,330339,200733,394197,383908,41046,254977,139220,827,9437,27006,186,378,223,601,65,91,156,49,15,64,13,1019,114.0,54.0
172,UTTAR PRADESH,Fatehpur,25.8374362030905,80.85416203090509,2632733,1384722,558807,77733,1248011,1512166,911003,601163,1063929,895178,75263,713736,350193,3385,33501,97968,539,1076,597,1673,190,266,456,114,43,157,43,2868,111.0,57.0
174,UTTAR PRADESH,Kaushambi,25.53587532051282,81.41811282051287,1599596,838485,349856,30764,761111,813424,507279,306145,639086,670750,43753,402644,236442,1503,15029,52946,312,620,350,970,106,149,255,76,17,93,14,1645,110.0,51.0
175,UTTAR PRADESH,Allahabad,25.392038662316445,82.05172446982063,5954391,3131807,983266,265304,2822584,3665727,2199340,1466387,2111907,1756098,391542,1426110,685797,24122,85491,355913,1075,2389,1820,4209,451,602,1053,379,211,590,300,7224,111.0,62.0
176,UTTAR PRADESH,Bara Banki,26.922777025232424,81.35762350597606,3260699,1707073,635840,79068,1553626,1692458,1010518,681940,1192850,1540841,108116,871241,321609,3159,26293,116157,564,1160,767,1927,194,275,469,186,40,226,45,3230,110.0,52.0
177,UTTAR PRADESH,Faizabad,26.60589185185181,82.00783530864202,2470996,1259628,510378,79288,1211368,1450901,838339,612562,831209,981915,127754,597888,233321,4746,28625,99531,513,1063,698,1761,183,260,443,152,51,203,65,2985,104.0,59.0
178,UTTAR PRADESH,Ambedkar Nagar,26.39119025974028,82.68282142857147,2397888,1212410,501559,65031,1185478,1486939,846676,640263,787398,813502,99581,547406,239992,2509,27308,61470,511,1031,624,1655,176,248,424,142,35,177,30,2797,102.0,62.0
179,UTTAR PRADESH,Sultanpur,26.2846386419753,82.05710456790123,3797117,1914586,839737,49891,1882531,2239902,1300248,939654,1242632,1118891,233701,869838,372794,5956,44008,135697,730,1497,1037,2534,240,347,587,274,28,302,37,4190,102.0,59.0
180,UTTAR PRADESH,Bahraich,27.691776300578027,81.46779783237004,3487731,1843884,698520,61742,1643847,1398368,878285,520083,1152160,1920966,85814,895576,256584,2681,35463,71676,584,1161,624,1785,204,286,490,119,44,163,37,3060,112.0,40.0
182,UTTAR PRADESH,Balrampur,27.449076537911324,82.47158326180256,2148665,1114721,410070,35768,1033944,868357,544943,323414,760253,1332817,57400,534332,225921,1551,15510,34497,393,795,496,1291,134,190,324,115,24,139,26,2174,108.0,40.0
183,UTTAR PRADESH,Gonda,27.157215552099505,82.0226888024882,3433919,1787146,673578,52794,1646773,1679994,1034181,645813,1170552,1620782,104084,855848,314704,4313,31811,78099,637,1301,864,2165,215,306,521,215,35,250,41,3614,109.0,49.0
185,UTTAR PRADESH,Basti,26.833880454545447,82.69790590909092,2464464,1255272,513960,31065,1209192,1393783,819719,574064,783688,1021192,108101,558642,225046,3423,30244,76856,478,989,692,1681,158,228,386,185,20,205,24,2775,104.0,57.0
186,UTTAR PRADESH,Sant Kabir Nagar,26.791596516393444,83.0387764344262,1715183,869656,324972,27179,845527,954949,567098,387851,539469,683053,79525,383482,155987,2031,19729,49191,340,684,416,1100,114,163,277,96,18,114,17,1850,103.0,56.0
188,UTTAR PRADESH,Gorakhpur,26.63315886792452,83.3549560377358,4440895,2277777,761958,189170,2163118,2700328,1593890,1106438,1351629,1453960,296619,1016876,334753,14597,65360,255280,792,1799,1464,3263,304,426,730,365,131,496,175,5455,105.0,61.0
189,UTTAR PRADESH,Kushinagar,26.892530675909864,83.92261542461007,3564544,1818055,742324,42775,1746489,1954820,1183722,771098,1116973,1550315,127331,804857,312116,3486,35931,103014,692,1374,836,2210,227,328,555,195,23,218,27,3704,104.0,55.0
190,UTTAR PRADESH,Deoria,26.42218856548857,83.8244070686071,3100946,1537436,597778,67928,1563510,1875239,1079288,795951,876246,1130108,150001,639073,237173,4469,36068,122308,633,1302,867,2169,218,312,530,205,47,252,58,3643,98.0,60.0
191,UTTAR PRADESH,Azamgarh,26.00829095477384,83.01220251256285,4613913,2285004,891024,80434,2328909,2771917,1559414,1212503,1372032,1218146,183381,941890,430142,6652,47324,159910,870,1882,1425,3307,296,423,719,400,56,456,67,5419,98.0,60.0
192,UTTAR PRADESH,Mau,26.01082203791469,83.50582654028433,2205968,1114709,352207,99321,1091259,1363044,773082,589962,696747,659237,149908,475413,221334,2656,26716,82073,402,919,688,1607,158,208,366,189,76,265,54,2693,102.0,62.0
193,UTTAR PRADESH,Ballia,25.86075638297873,84.03651978723408,3239774,1672902,564927,64454,1566872,1963590,1160960,802630,1019483,1032533,119972,723060,296423,4672,42969,115533,611,1273,901,2174,215,303,518,223,45,268,64,3634,107.0,61.0
194,UTTAR PRADESH,Jaunpur,25.70141280913127,82.54315351934063,4494204,2220465,926088,80582,2273739,2731677,1565394,1166283,1437375,1344789,181467,934157,503218,8002,52398,211780,845,1824,1389,3213,286,411,697,387,52,439,69,5261,98.0,61.0
195,UTTAR PRADESH,Ghazipur,25.624724775583484,83.5360854578097,3620268,1855075,700173,61467,1765193,2197549,1293553,903996,1204602,1008996,105767,808700,395902,5309,50180,139187,702,1443,993,2436,248,343,591,245,40,285,63,4079,105.0,61.0
196,UTTAR PRADESH,Chandauli,25.1180859611231,83.25307062634984,1952756,1017905,344937,50822,934851,1174606,699454,475152,652543,543247,99602,462971,189572,3492,20762,109887,383,789,507,1296,133,188,321,121,31,152,30,2183,109.0,60.0
197,UTTAR PRADESH,Varanasi,25.36057088888889,82.82529666666672,3676841,1921857,438935,316129,1754984,2403903,1389116,1014787,1220708,906367,336056,921234,299474,19214,57583,309911,616,1533,1401,2934,304,391,695,299,214,513,302,5059,110.0,65.0
199,UTTAR PRADESH,Mirzapur,25.10207959183675,82.60126628571429,2496970,1312302,465152,77963,1184668,1428683,865837,562846,881996,868542,145997,613061,268935,4447,24518,136132,489,1024,679,1703,176,245,421,160,52,212,52,2875,111.0,57.0
200,UTTAR PRADESH,Sonbhadra,24.46693268858798,83.06816324951639,1862559,971344,337048,91040,891215,985708,601988,383720,730399,745126,95582,463611,266788,5149,25220,80712,323,774,631,1405,130,173,303,178,69,247,59,2337,109.0,53.0
201,UTTAR PRADESH,Etah,27.591155309734443,78.70021858407083,1774480,947339,334246,67752,827141,1055202,647042,408160,545984,718310,69591,440244,105740,2635,19712,79090,679,1347,602,1949,256,348,604,66,93,159,71,3461,115.0,59.0
203,BIHAR,Pashchim Champaran,27.16064352201258,84.30265911949685,3935042,2061110,839514,96620,1873932,1759481,1091226,668255,1478947,1710878,57546,999282,479665,3495,41143,69056,935,1347,621,1968,138,21,159,30,49,79,40,3181,110.0,45.0
204,BIHAR,Purba Champaran,26.68129336734693,85.00382155612242,5099371,2681209,1142260,101565,2418162,2276957,1407603,869354,1737539,2142757,74979,1260774,476765,7719,70258,96546,1194,1754,797,2551,223,18,241,25,40,65,47,4098,111.0,45.0
205,BIHAR,Sheohar,26.458380748663107,85.29539411764709,656246,346673,158484,7516,309573,283698,171645,112053,216372,348078,10004,166693,49679,478,6698,11722,173,211,90,301,4,1,5,2,3,5,4,489,112.0,43.0
206,BIHAR,Sitamarhi,26.56570069686413,85.61172491289203,3423574,1803252,807294,49670,1620322,1436794,885188,551606,1114583,1852765,66263,865929,248654,3460,42461,61089,866,1150,520,1670,69,10,79,14,22,36,29,2679,111.0,42.0
207,BIHAR,Madhubani,26.41380538172716,86.16328360450552,4487379,2329313,1047552,41234,2158066,2155338,1340085,815253,1636938,2003079,113281,1105947,530991,5319,65548,73851,1090,1535,668,2203,165,7,172,10,17,27,26,3520,108.0,48.0
208,BIHAR,Supaul,26.28157893772896,86.78496465201461,2229076,1155283,572287,27815,1073793,1033283,647672,385611,877682,1220268,51028,551718,325964,1845,25078,26559,533,797,350,1147,114,5,119,8,12,20,15,1836,108.0,46.0
209,BIHAR,Araria,26.211528119180603,87.30766554934816,2811569,1463333,659061,44213,1348236,1195768,727643,468125,1069893,1653766,43290,708391,361502,2561,29796,40387,708,866,375,1241,24,9,33,12,20,32,22,2035,109.0,43.0
210,BIHAR,Kishanganj,26.32433675832129,87.95045007235886,1690400,866970,401793,43357,823430,745056,439921,305135,529064,945397,58718,421192,107872,1093,14073,28736,402,574,260,834,55,9,64,13,20,33,14,1347,105.0,44.0
211,BIHAR,Purnia,25.81714801901739,87.40447606973065,3264619,1699370,712847,85749,1565249,1332326,805261,527065,1143318,1798786,86058,803275,340043,4170,33664,63200,822,1115,521,1636,74,16,90,22,35,57,36,2641,109.0,41.0
212,BIHAR,Katihar,25.56565356037151,87.70466083591326,3071029,1600430,668232,69838,1470599,1280190,762256,517934,1013566,1705551,60900,760522,253044,2941,27263,60110,732,1069,491,1560,124,14,138,20,33,53,31,2516,109.0,42.0
213,BIHAR,Madhepura,25.77341929460581,86.8978443983403,2001762,1047559,486278,24000,954203,834577,517666,316911,777546,1202278,23236,496046,281500,1397,23309,23209,487,651,285,936,45,3,48,4,7,11,12,1494,110.0,42.0
214,BIHAR,Saharsa,25.821270696721303,86.54670819672135,1900661,997174,432651,38046,903487,804996,506374,298622,649898,1151349,41342,456724,193174,1668,19415,30518,464,672,311,983,78,8,86,11,18,29,21,1582,110.0,42.0
215,BIHAR,Darbhanga,26.146187719298258,85.97387352472099,3937385,2059949,907174,95539,1877436,1816634,1125566,691068,1223640,2203198,127442,947927,275713,6280,53205,80085,994,1489,695,2184,211,16,227,23,37,60,49,3514,110.0,46.0
216,BIHAR,Muzaffarpur,26.18664417177915,85.32745092024543,4801062,2527497,998694,120700,2273565,2509232,1487117,1022115,1547586,1924438,180651,1195308,352278,10290,73012,172027,1064,1719,828,2547,322,22,344,30,49,79,70,4105,111.0,52.0
217,BIHAR,Gopalganj,26.44874364161851,84.34636127167629,2562012,1267666,515925,38133,1294346,1382998,793905,589093,728201,977719,69375,539586,188615,3707,33596,61380,596,1022,458,1480,229,9,238,12,20,32,25,2370,98.0,54.0
218,BIHAR,Siwan,26.1736372013652,84.33766552901022,3330464,1675090,632514,41858,1655374,1930175,1115906,814269,932416,1207119,52935,730396,202020,3834,37833,74071,734,1292,596,1888,318,9,327,13,21,34,32,3014,101.0,58.0
219,BIHAR,Saran,25.89656077844312,84.82266287425155,3951862,2022821,701323,76299,1929041,2157454,1285767,871687,1040231,1313700,94787,857660,182571,4509,37442,128169,892,1553,726,2279,355,19,374,27,43,70,52,3667,105.0,55.0
220,BIHAR,Vaishali,25.8134703180212,85.39247597173153,3495021,1844535,699317,51494,1650486,1926740,1152576,774164,1060344,1479152,70001,858648,201696,4810,39564,101269,773,1254,573,1827,240,12,252,17,27,44,35,2930,112.0,55.0
221,BIHAR,Samastipur,25.793205563909765,85.94833323308269,4261566,2230003,1012979,43486,2031563,2142880,1293575,849305,1343400,1996651,88021,1037576,305824,5379,50918,84248,1005,1534,661,2195,248,6,254,8,13,21,23,3500,110.0,50.0
222,BIHAR,Begusarai,25.54302613168723,86.12560144032932,2970541,1567660,594377,139248,1402881,1548673,918507,630166,938182,1242551,120373,715345,222837,4644,43127,76761,751,1029,447,1476,92,5,97,5,8,13,18,2354,112.0,52.0
223,BIHAR,Khagaria,25.53558891454964,86.56593256351037,1666886,883786,373696,21007,783100,768028,461153,306875,560805,903323,40641,398216,162589,1580,21654,31220,406,535,245,780,28,5,33,7,11,18,16,1254,113.0,46.0
224,BIHAR,Bhagalpur,25.27719288537548,87.04213814229242,3037766,1615663,522527,130634,1422103,1573066,937669,635397,983528,1139715,174534,740056,243472,6764,46929,117040,667,1127,593,1720,215,30,245,42,69,111,70,2814,114.0,52.0
225,BIHAR,Banka,24.832355642023337,86.8664916342413,2034763,1067140,425604,18492,967623,965321,590961,374360,771080,879831,62359,517817,253263,1704,22300,32859,510,764,325,1089,112,4,116,5,8,13,10,1738,110.0,47.0
226,BIHAR,Munger,25.198537962962963,86.54173672839504,1367765,729041,222281,85782,638724,801817,473741,328076,426658,498676,90461,327453,99205,2653,17946,69973,287,554,307,861,137,20,157,29,46,75,42,1424,114.0,59.0
227,BIHAR,Lakhisarai,25.183449321266963,86.12825701357468,1000912,526345,175882,31763,474567,507270,305182,202088,326576,450967,44491,240494,86082,1186,8862,31048,222,376,181,557,75,8,83,11,17,28,15,904,111.0,51.0
228,BIHAR,Sheikhpura,25.12472436548223,85.77839390862943,636342,329743,108293,24345,306599,328676,196431,132245,224655,305609,20065,151569,73086,631,8873,16279,153,231,116,347,30,5,35,7,12,19,12,565,108.0,52.0
229,BIHAR,Nalanda,25.229345508982053,85.48053113772461,2877653,1497060,514141,102522,1380593,1519933,919558,600375,1045420,1324385,101378,703405,342015,4156,43848,87070,624,1064,523,1587,216,22,238,31,51,82,48,2578,108.0,53.0
230,BIHAR,Patna,25.40297114503818,85.3198433587787,5838465,3078512,657991,552103,2759953,3459679,2028047,1431632,1881886,2590473,546859,1436411,445475,40692,132582,453344,1091,2325,1877,4202,692,129,821,180,293,473,476,7065,112.0,59.0
231,BIHAR,Bhojpur,25.50666439393939,84.49407803030304,2728407,1430380,434559,77368,1298027,1599151,973486,625665,822493,1005140,62153,640283,182210,3661,34658,87879,602,1068,535,1603,243,21,264,30,48,78,53,2600,110.0,59.0
232,BIHAR,Buxar,25.48593018867924,84.08808081760995,1706352,887977,299252,35405,818375,989807,593544,396263,538322,457814,46760,402180,136142,1784,19324,48405,392,653,313,966,135,8,143,12,19,31,25,1556,109.0,58.0
234,BIHAR,Rohtas,24.99170460829495,83.9350762672811,2959918,1543546,512383,95678,1416372,1799832,1061783,738049,924879,876443,114893,707939,216940,4594,36279,106218,299,588,363,951,167,20,187,28,45,73,46,1555,109.0,61.0
235,BIHAR,Aurangabad,24.77429186746988,84.45986024096379,2540073,1318684,428291,49006,1221389,1466002,868733,597269,837770,784131,44456,599157,238613,2362,31168,45871,585,940,435,1375,170,12,182,17,27,44,29,2215,108.0,58.0
235,BIHAR,Aurangabad,20.0979228832952,75.32072196796334,2540073,1318684,428291,49006,1221389,1466002,868733,597269,837770,784131,44456,599157,238613,2362,31168,45871,585,940,435,1375,170,12,182,17,27,44,29,2215,108.0,58.0
515,MAHARASHTRA,Aurangabad,24.77429186746988,84.45986024096379,3701282,1924469,551789,427343,1776813,2503837,1430936,1072901,1575079,819734,589477,1015864,559215,23258,69937,403594,472,1966,1997,3963,463,676,1139,900,1144,2044,501,8119,108.0,68.0
515,MAHARASHTRA,Aurangabad,20.0979228832952,75.32072196796334,3701282,1924469,551789,427343,1776813,2503837,1430936,1072901,1575079,819734,589477,1015864,559215,23258,69937,403594,472,1966,1997,3963,463,676,1139,900,1144,2044,501,8119,108.0,68.0
236,BIHAR,Gaya,24.7266541547278,84.94291217765044,4391418,2266566,696289,111282,2124852,2297613,1368803,928810,1664062,1953368,112617,1076170,587892,6856,57011,107970,979,1650,813,2463,330,32,362,45,73,118,75,3998,107.0,52.0
237,BIHAR,Nawada,24.825708836206903,85.61594568965519,2219146,1144668,379551,45323,1074478,1091012,659474,431538,817041,1091439,31162,539439,277602,1841,28411,34020,561,820,374,1194,98,10,108,14,23,37,22,1924,107.0,49.0
238,BIHAR,Jamui,24.78418380462726,86.26316298200514,1760405,916064,325909,30851,844341,858588,534385,324203,727571,765297,32633,452288,275283,1839,22414,27056,396,654,291,945,130,7,137,9,15,24,14,1516,108.0,49.0
239,BIHAR,Jehanabad,25.155679045643165,84.9208124481328,1125313,585582,186660,28132,539731,618881,374412,244469,365378,495877,27641,266423,98955,1106,11302,32086,248,408,190,598,81,5,86,6,10,16,13,960,108.0,55.0
245,ARUNACHAL PRADESH,Tawang,27.680683962264148,91.82504245283016,49977,29151,10730,2452,20826,26073,17720,8353,28561,19203,8635,19554,9007,96,494,4824,52,161,70,231,28,21,49,6,6,12,4,348,140.0,52.0
246,ARUNACHAL PRADESH,West Kameng,27.46486582278483,92.65015750452083,83947,46155,17889,6306,37792,48492,29566,18926,42493,25606,14188,28313,14180,202,887,8634,52,161,70,231,28,21,49,6,6,12,4,348,122.0,58.0
247,ARUNACHAL PRADESH,East Kameng,27.371194055944056,93.04741486013997,78690,38775,14503,5215,39915,38449,21599,16850,31710,31763,5318,16424,15286,57,885,3169,52,161,70,231,28,21,49,6,6,12,4,348,97.0,49.0
248,ARUNACHAL PRADESH,Papum Pare,27.273529716981127,93.54468183962264,176573,89182,20308,30180,87391,121048,65794,55254,65772,30360,30539,41263,24509,2477,7418,23203,68,193,192,385,64,41,105,21,25,46,40,644,102.0,69.0
249,ARUNACHAL PRADESH,Upper Subansiri,28.277196566523585,93.8991435622318,83448,41758,14542,4672,41690,45278,24807,20471,33370,28364,5373,17898,15472,139,750,3580,52,161,70,231,28,21,49,6,6,12,4,348,100.0,54.0
250,ARUNACHAL PRADESH,West Siang,28.106296920289843,94.53510344202908,112274,58168,22272,8503,54106,64746,36777,27969,49177,27956,14204,29156,20021,303,1300,9593,52,161,70,231,28,21,49,6,6,12,4,348,108.0,58.0
251,ARUNACHAL PRADESH,East Siang,28.15382352941176,95.06499226006191,99214,50116,19497,9524,49098,62576,34210,28366,40222,21543,14231,23591,16631,450,1582,9363,68,193,192,385,64,41,105,21,25,46,40,644,102.0,63.0
252,ARUNACHAL PRADESH,Upper Siang,28.8309244897959,95.00155765306124,35320,18699,8569,2182,16621,18195,10723,7472,17644,11209,6198,9968,7676,97,392,2823,52,161,70,231,28,21,49,6,6,12,4,348,113.0,52.0
253,ARUNACHAL PRADESH,Changlang,27.36048479338845,96.37552644628106,148226,76948,33422,6498,71278,73174,44027,29147,62966,57290,14593,39329,23637,170,1486,9314,52,161,70,231,28,21,49,6,6,12,4,348,108.0,49.0
254,ARUNACHAL PRADESH,Tirap,26.94406229508198,95.41470327868862,111975,57604,18420,6500,54371,47974,29313,18661,50169,50628,16026,27545,22624,98,888,6118,52,161,70,231,28,21,49,6,6,12,4,348,106.0,43.0
255,ARUNACHAL PRADESH,Lower Subansiri,27.70849297297297,93.96226108108112,83030,41843,18112,5365,41187,54057,29470,24587,30202,17273,12493,17339,12863,381,1598,7285,52,161,70,231,28,21,49,6,6,12,4,348,102.0,65.0
256,ARUNACHAL PRADESH,Kurung Kumey,28.04853351800553,93.24531994459834,92076,45318,18603,1092,46758,36606,20258,16348,38044,42621,3911,18429,19615,95,969,1320,52,161,70,231,28,21,49,6,6,12,4,348,97.0,40.0
258,ARUNACHAL PRADESH,Lower Dibang Valley,28.32651730103806,95.76567335640142,54080,28053,12000,3950,26027,31849,18087,13762,22326,14406,5932,14102,8224,207,742,4345,52,161,70,231,28,21,49,6,6,12,4,348,108.0,59.0
259,ARUNACHAL PRADESH,Lohit,27.946785273972623,96.59670770547945,145726,76221,33599,11372,69505,83062,48380,34682,60945,52421,17157,38910,22035,312,1471,12215,52,161,70,231,28,21,49,6,6,12,4,348,110.0,57.0
261,NAGALAND,Mon,26.69207374301676,95.03072988826828,250260,131753,43607,7415,118507,119626,67432,52194,147654,130529,14398,79425,68229,178,2844,5647,79,210,42,252,33,3,36,4,6,10,5,381,111.0,48.0
262,NAGALAND,Mokokchung,26.478911764705888,94.522426006192,194622,101092,37536,17742,93530,159494,83479,76015,100067,22555,40154,57084,42983,537,2728,20192,53,169,63,232,32,5,37,6,10,16,8,346,108.0,82.0
263,NAGALAND,Zunheboto,26.028178205128206,94.50026666666668,140757,71217,31267,6044,69540,102881,53504,49377,79466,25988,28846,41178,38288,261,2008,9954,36,132,56,188,25,8,33,7,11,18,1,275,102.0,73.0
264,NAGALAND,Wokha,26.202611551155112,94.1990815181518,166343,84505,38499,8170,81838,128208,67385,60823,78412,25048,25268,42096,36316,198,1757,10923,42,161,78,239,30,12,42,14,20,34,0,359,103.0,77.0
265,NAGALAND,Dimapur,25.814176811594223,93.75074057971014,378811,197394,49116,62853,181417,278037,150142,127895,151350,58926,71413,99645,51705,3303,12077,50453,52,213,308,521,100,46,146,31,43,74,74,866,109.0,73.0
266,NAGALAND,Phek,25.63272986577182,94.56814563758392,163418,83743,38903,7295,79675,105893,57926,47967,80277,44456,36182,41556,38721,170,1558,9553,35,112,37,149,22,3,25,3,5,8,3,219,105.0,65.0
267,NAGALAND,Tuensang,26.21104453280316,94.85809880715708,196596,101933,40690,9451,94663,117511,63653,53858,98154,66450,24998,52931,45223,155,2251,7687,35,116,40,156,23,2,25,3,4,7,4,228,108.0,60.0
270,NAGALAND,Kohima,25.60311428571428,93.78600657596373,267988,138966,31845,44255,129022,197489,107038,90451,114825,45802,50724,68140,46685,1928,7982,29077,59,218,190,408,90,24,114,19,26,45,51,677,108.0,74.0
272,MANIPUR,Senapati,25.08465586034914,94.03366234413956,479148,247323,38008,1826,231825,264477,148012,116465,233622,191001,22798,124143,109479,256,2170,9623,62,502,165,667,71,24,95,0,0,0,0,823,107.0,55.0
273,MANIPUR,Tamenglong,24.98312942238265,93.49450740072204,140651,72371,23982,4119,68280,85006,47403,37603,70675,45317,11541,37237,33438,125,1362,5233,51,29,10,39,0,0,0,0,0,0,0,90,106.0,60.0
274,MANIPUR,Churachandpur,24.30309718875504,93.38671506024085,274143,138820,52972,4853,135323,195935,104013,91922,122655,57561,29894,70594,52061,837,4496,17498,42,242,17,259,26,0,26,0,0,0,0,327,103.0,71.0
275,MANIPUR,Bishnupur,24.50712111801243,93.8246236024845,237399,118782,34977,21172,118617,156333,87313,69020,109937,67610,34364,62807,47130,676,3447,23140,77,46,56,102,9,13,22,16,9,25,0,226,100.0,66.0
276,MANIPUR,Thoubal,24.545392553191498,93.97959893617023,422168,210845,65961,38302,211323,269304,152617,116687,195319,118088,49507,109377,85942,880,5110,34893,97,229,108,337,32,24,56,30,20,50,0,539,100.0,64.0
279,MANIPUR,Ukhrul,25.05900314960629,94.44129566929138,183998,94718,36084,5806,89280,129829,70148,59681,87929,42156,14026,46533,41396,276,2437,7360,79,0,0,0,0,0,0,0,0,0,0,79,106.0,71.0
280,MANIPUR,Chandel,24.2635812987013,94.09443844155844,144182,74579,30377,3783,69603,90302,51053,39249,76238,38191,18764,42615,33623,184,1782,8319,24,147,44,191,22,6,28,4,2,6,0,250,107.0,63.0
281,MIZORAM,Mamit,23.73852942502819,92.4330803833147,86364,44828,16726,4129,41536,60191,32977,27214,39339,20091,12158,24016,15323,90,1073,6263,14,42,23,65,7,9,16,0,0,0,0,94,108.0,70.0
282,MIZORAM,Kolasib,24.2020004347826,92.73470391304348,83955,42918,9669,12507,41037,65895,34147,31748,36672,14217,14853,22733,13939,367,1986,8392,9,39,49,88,8,10,18,8,11,19,10,142,105.0,78.0
283,MIZORAM,Aizawl,23.90781335453101,92.85359459459472,400309,199270,20570,80341,201039,340595,169547,171048,174636,38248,79804,104643,69993,4019,21093,59257,46,186,306,492,141,48,189,47,64,111,125,963,99.0,85.0
284,MIZORAM,Champhai,23.54166580976866,93.24221799485862,125745,63388,18395,12717,62357,100802,51440,49362,60342,15449,23948,34129,26213,186,2263,13445,22,63,51,114,13,10,23,7,11,18,10,187,102.0,80.0
285,MIZORAM,Serchhip,23.263864705882344,92.914158496732,64937,32851,7472,8018,32086,54476,27598,26878,32397,5963,12315,18261,14136,131,987,7043,10,37,37,74,6,9,15,6,9,15,4,118,102.0,84.0
286,MIZORAM,Lunglei,23.007717036172675,92.63512555425892,161428,82891,21479,17315,78537,121122,64515,56607,78292,32451,26394,46230,32062,482,3725,15871,26,84,80,164,22,17,39,11,16,27,18,274,106.0,75.0
287,MIZORAM,Lawngtlai,22.36102843137253,92.66964156862753,117894,60599,21993,5273,57295,62861,36444,26417,45566,54874,9283,28517,17049,162,1329,6657,30,87,60,147,17,14,31,11,18,29,4,242,106.0,53.0
288,MIZORAM,Saiha,22.35744801061008,93.02827931034489,56574,28594,7043,5784,27980,42233,21861,20372,19461,8787,7400,12211,7250,168,1194,4797,18,32,17,49,10,2,12,2,3,5,4,88,102.0,75.0
289,TRIPURA,West Tripura,23.780166241299337,91.41310788863107,1725739,879428,289621,217016,846311,1361354,722998,638356,698178,279053,314567,500406,197772,6394,36186,231324,297,909,779,1688,255,221,476,72,96,168,188,2817,104.0,79.0
290,TRIPURA,South Tripura,23.211874098057383,91.6065807585568,876001,447544,219171,44906,428457,646810,351082,295728,366845,188363,133744,253229,113616,948,10393,78159,170,455,259,714,92,96,188,10,13,23,23,1118,104.0,74.0
291,TRIPURA,Dhalai,23.781360477941163,91.94654283088232,378230,194544,89457,14071,183686,276217,151643,124574,155831,109130,46875,105657,50174,273,5067,24750,65,187,121,308,31,45,76,7,0,7,0,455,106.0,73.0
292,TRIPURA,North Tripura,24.121739755351683,92.17842538226292,693947,352860,150437,42184,341087,520402,275646,244756,248667,156840,81601,186034,62633,997,10310,43755,139,349,171,520,78,58,136,11,15,26,26,848,103.0,75.0
293,MEGHALAYA,West Garo Hills,25.495285185185185,90.03709947089942,643291,324159,139351,18594,319132,358702,193438,165264,255693,208900,51301,151914,103779,1630,8872,35051,127,355,148,503,66,49,115,11,16,27,17,791,102.0,56.0
294,MEGHALAYA,East Garo Hills,25.82728228228228,90.64684924924916,317917,161223,62698,11518,156694,192147,102513,89634,126073,100781,24550,72262,53811,288,2368,15115,58,191,101,292,32,37,69,13,19,32,0,450,103.0,60.0
295,MEGHALAYA,South Garo Hills,25.240568578553614,90.64560349127176,142334,73170,35930,3713,69164,82062,45003,37059,53069,44849,10940,32826,20243,179,1625,6721,26,70,22,92,13,10,23,0,0,0,0,139,106.0,58.0
296,MEGHALAYA,West Khasi Hills,25.500889926739926,91.25364542124538,383461,193715,74832,12299,189746,230678,117307,113371,163345,133244,32873,89694,73651,149,2462,12548,76,216,88,304,40,29,69,9,15,24,6,479,102.0,60.0
298,MEGHALAYA,East Khasi Hills,25.303763888888884,91.75922519841272,825922,410749,106248,108843,415173,578030,287270,290760,326786,168575,135941,204303,122483,5032,19306,79933,113,413,432,845,158,98,256,48,65,113,128,1456,99.0,70.0
299,MEGHALAYA,Jaintia Hills,25.33959557069844,92.37608160136298,395124,196285,76546,7171,198839,187527,87371,100156,154180,165184,41677,88839,65341,510,4333,17352,63,213,141,354,38,48,86,10,6,16,9,528,99.0,47.0
300,ASSAM,Kokrajhar,26.497246635730868,90.13997470997688,887142,452905,204896,17115,434237,489305,275220,214085,341131,340601,41373,236322,104809,1218,14063,32320,52,161,70,231,28,21,49,6,6,12,4,348,104.0,55.0
302,ASSAM,Goalpara,26.017277777777807,90.59869891598912,1008183,513292,228610,39504,494891,563577,304302,259275,362573,375071,78641,267118,95455,1364,13524,42628,52,161,70,231,28,21,49,6,6,12,4,348,104.0,56.0
303,ASSAM,Barpeta,26.427872264631056,90.97912010178116,1693622,867004,447189,52192,826618,897058,499038,398020,561824,664161,84804,445297,116527,2078,25286,55319,52,161,70,231,28,21,49,6,6,12,4,348,105.0,53.0
305,ASSAM,Nagaon,26.26462170626351,92.9306191144708,2823768,1439112,674999,124186,1384656,1710716,921850,788866,979998,873197,195631,766728,213270,5121,45956,127523,52,161,70,231,28,21,49,6,6,12,4,348,104.0,61.0
306,ASSAM,Sonitpur,26.73514926829268,92.85197804878044,1924110,983904,483325,64528,940206,1108572,620525,488047,770606,627141,133368,537195,233411,4358,31254,106909,52,161,70,231,28,21,49,6,6,12,4,348,105.0,58.0
307,ASSAM,Lakhimpur,27.14128805970149,94.0775949253732,1042137,529674,293239,34694,512463,683486,375552,307934,429995,275677,60296,282250,147745,1948,15011,45689,52,161,70,231,28,21,49,6,6,12,4,348,103.0,66.0
308,ASSAM,Dhemaji,27.586533438485816,94.71336908517353,686133,351249,211758,16504,334884,423028,237761,185267,316800,194984,28195,186577,130223,1192,10410,25776,52,161,70,231,28,21,49,6,6,12,4,348,105.0,62.0
309,ASSAM,Tinsukia,27.53549291139241,95.69055949367085,1327929,680231,290704,90910,647698,798322,453449,344873,557196,417081,161718,366623,190573,5135,27948,111738,52,161,70,231,28,21,49,6,6,12,4,348,105.0,60.0
310,ASSAM,Dibrugarh,27.30612284482757,95.0998282327587,1326335,676434,299852,77163,649901,884531,491361,393170,560557,340744,136685,368013,192544,8817,34479,121737,52,161,70,231,28,21,49,6,6,12,4,348,104.0,67.0
312,ASSAM,Jorhat,26.76244824016563,94.30197722567289,1092256,556805,286330,80824,535451,794929,432335,362594,498618,209170,122063,320746,177872,5651,26357,92598,52,161,70,231,28,21,49,6,6,12,4,348,104.0,73.0
313,ASSAM,Golaghat,26.377219709794485,93.82583397823468,1066888,543161,292893,34190,523727,721764,396475,325289,479928,258897,82345,309104,170824,3073,17636,70930,52,161,70,231,28,21,49,6,6,12,4,348,104.0,68.0
314,ASSAM,Karbi Anglong,26.08966454598031,93.11536570271832,956313,490167,215691,37185,466146,557214,314253,242961,383441,310093,53918,246193,137248,1923,11340,56689,52,161,70,231,28,21,49,6,6,12,4,348,105.0,58.0
316,ASSAM,Cachar,24.815570668693017,92.86849650455927,1736617,886284,346227,88933,850333,1174128,639946,534182,608062,357907,140205,469752,138310,5316,37541,99887,52,161,70,231,28,21,49,6,6,12,4,348,104.0,68.0
317,ASSAM,Karimganj,24.69660712250711,92.3679498575498,1228686,625864,261945,32695,602822,795297,435942,359355,399171,303785,70951,319798,79373,1933,24699,38570,52,161,70,231,28,21,49,6,6,12,4,348,104.0,65.0
318,ASSAM,Hailakandi,24.457496089385486,92.59154664804475,659296,337890,159215,16202,321406,407366,226836,180530,214240,173306,44143,170792,43448,1211,10615,19998,52,161,70,231,28,21,49,6,6,12,4,348,105.0,62.0
319,ASSAM,Bongaigaon,26.45012521994133,90.6734296187684,738804,375818,181923,38470,362986,434078,237114,196964,255806,260721,49866,197542,58264,2523,12959,36350,52,161,70,231,28,21,49,6,6,12,4,348,104.0,59.0
321,ASSAM,Kamrup,26.170939452054807,91.58863273972592,1517542,778461,390596,43849,739081,995319,550219,445100,628954,392678,122191,428492,200462,3109,23468,90941,52,161,70,231,28,21,49,6,6,12,4,348,105.0,66.0
323,ASSAM,Nalbari,26.46323767605632,91.40598521126763,771639,396006,210706,28238,375633,531771,293184,238587,267623,188960,68313,210202,57421,1631,12360,45938,52,161,70,231,28,21,49,6,6,12,4,348,105.0,69.0
325,ASSAM,Darrang,26.58463215962442,92.04141338028155,928500,475273,268517,20189,453227,487039,268666,218373,324843,375556,45444,246864,77979,1166,12084,30616,52,161,70,231,28,21,49,6,6,12,4,348,105.0,52.0
327,WEST BENGAL,Darjiling,26.839619571045585,88.33145067024122,1846823,937259,303284,215675,909564,1315585,717673,597912,683726,415353,297176,479586,204140,10943,38065,222987,366,837,754,1591,322,233,555,131,245,376,257,3146,103.0,71.0
328,WEST BENGAL,Jalpaiguri,26.62642031250004,89.04154375000003,3872846,1983064,798378,319426,1889782,2498780,1396622,1102158,1512910,1203423,382500,1091361,421549,9322,48818,268908,863,1859,1088,2947,530,202,732,168,336,504,114,5160,105.0,65.0
330,WEST BENGAL,Uttar Dinajpur,26.044619165196977,88.23595232216337,3007134,1551066,683981,94269,1456068,1489667,853495,636172,1075626,1431264,199307,799627,275999,2883,31210,105431,710,1306,641,1947,220,79,299,79,159,238,20,3214,107.0,50.0
331,WEST BENGAL,Dakshin Dinajpur,25.342094363021435,88.69821679819614,1676276,857199,390949,70077,819077,1083685,596474,487211,702987,534394,168069,499560,203427,2518,24318,103980,429,810,412,1222,152,57,209,51,104,155,23,2039,105.0,65.0
332,WEST BENGAL,Maldah,25.08026802575105,88.17191684549356,3988845,2051541,830318,128678,1937304,2086432,1152019,934413,1537847,1960034,297716,1086461,451386,5357,63525,142659,946,1764,833,2597,283,95,378,63,121,184,86,4191,106.0,52.0
333,WEST BENGAL,Murshidabad,24.25950655391121,88.16816860465121,7103807,3627564,1501066,350899,3476243,4055834,2177187,1878647,2589907,3031841,541169,1985667,604240,7951,79729,296566,1645,3099,1663,4762,597,268,865,220,441,661,153,8088,104.0,57.0
334,WEST BENGAL,Birbhum,24.06389342723,87.65153089201888,3502404,1790920,831044,134565,1711484,2158447,1201481,956966,1331603,1346802,333752,1029770,301833,5210,39636,191514,791,1609,790,2399,346,100,446,59,112,171,105,3911,105.0,62.0
335,WEST BENGAL,Barddhaman,23.444453888888884,87.8150581111111,7717563,3966889,1364868,862368,3750674,5247208,2918040,2329168,2911251,2196886,1049943,2293083,618168,32323,141387,747286,1379,3561,3277,6838,1655,953,2608,642,1244,1886,835,13547,106.0,68.0
336,WEST BENGAL,Nadia,23.56410971055088,88.58293034547152,5167600,2653768,1081381,468390,2513832,3480555,1878866,1601689,1842607,1570127,623729,1554090,288517,12787,77210,384314,1160,2429,1520,3949,675,321,996,237,466,703,240,7048,106.0,67.0
338,WEST BENGAL,Hugli,22.87929264705881,88.00010264705891,5519145,2814653,992085,647953,2704492,4078388,2211777,1866611,2152870,1180806,965258,1713608,439262,31725,118459,628340,1048,2658,2224,4882,1163,601,1764,436,857,1293,463,9450,104.0,74.0
339,WEST BENGAL,Bankura,23.081280892857155,87.12640053571437,3596674,1838095,900515,90885,1758579,2232992,1299337,933655,1466220,1417787,334670,1050822,415398,4273,34128,177819,818,1684,785,2469,362,82,444,51,96,147,82,3959,105.0,62.0
340,WEST BENGAL,Puruliya,23.254192328767108,86.3968532876713,2930115,1496996,653219,99433,1433119,1624905,1002058,622847,1249642,1272799,189889,801254,448388,3551,32862,104489,640,1332,670,2002,313,90,403,65,127,192,71,3309,104.0,55.0
341,WEST BENGAL,Haora,22.401674174428507,87.99421176968654,4850029,2500819,483384,869313,2349210,3605206,1942824,1662382,1819845,926661,796953,1498170,321675,30751,99261,539312,760,2195,2364,4559,1255,720,1975,535,1055,1590,529,9414,106.0,74.0
342,WEST BENGAL,Kolkata,22.550581481481483,88.3527648148148,4496694,2356766,0,1308106,2139928,3588137,1926915,1661222,1795740,410988,927602,1412466,383274,136618,252644,816141,363,1472,4507,5979,2097,2287,4384,863,1402,2265,3383,16375,110.0,80.0
346,JHARKHAND,Garhwa,24.082114689265527,83.68664265536722,1322784,683575,272872,19180,639209,653476,405161,248315,571431,557852,29373,335451,235980,565,8881,21864,321,447,182,629,46,3,49,4,6,10,10,1017,107.0,49.0
347,JHARKHAND,Chatra,24.11619945750453,84.93295804701627,1042886,533935,200974,14528,508951,510061,303902,206159,397690,467975,27037,251213,146477,590,9115,17627,230,356,150,506,59,2,61,3,6,9,10,817,105.0,49.0
349,JHARKHAND,Giridih,24.30578509874329,86.08710915619386,2445474,1258098,452564,46886,1187376,1253475,783736,469739,1036277,1047685,125431,623946,412331,1944,19976,63911,613,1029,440,1469,207,13,220,18,30,48,34,2384,106.0,51.0
350,JHARKHAND,Deoghar,24.33070100755672,86.75697632241814,1492073,775022,257373,64337,717051,793538,489837,303701,551467,635544,130193,383691,167776,1944,13550,64890,329,518,254,772,86,9,95,13,21,34,36,1267,108.0,53.0
351,JHARKHAND,Godda,24.8189,87.2941735483871,1313551,677927,276454,15576,635624,604519,376212,228307,552191,653464,43230,344019,208172,874,11925,25764,299,468,189,657,81,3,84,4,6,10,9,1057,107.0,46.0
352,JHARKHAND,Sahibganj,24.93667989690721,87.68264097938142,1150567,589391,223450,37543,561176,483263,287303,195960,490202,637296,34879,295690,194512,591,9563,24604,276,404,178,582,47,7,54,9,15,24,17,954,105.0,42.0
353,JHARKHAND,Pakur,24.57260428082189,87.69691969178076,900422,452661,200588,16587,447761,352881,206989,145892,404584,548434,31414,234012,170572,328,4535,16500,212,301,125,426,33,2,35,3,5,8,8,691,101.0,39.0
354,JHARKHAND,Dhanbad,23.854509090909097,86.40372924901185,2684487,1405956,258764,405455,1278531,1722204,1014950,707254,844504,662522,427173,658851,185653,11568,46646,290580,529,1305,966,2271,393,101,494,141,230,371,288,3954,110.0,64.0
355,JHARKHAND,Bokaro,23.6814965034965,85.98398374125864,2062330,1072807,250312,258452,989523,1273520,759088,514432,685368,595924,274726,507677,177691,9754,37997,179570,539,1267,818,2085,360,87,447,121,197,318,213,3604,108.0,62.0
356,JHARKHAND,Lohardaga,23.488796043165483,84.6605169064748,461790,232629,96759,14725,229161,259707,149568,110139,221332,188323,28769,121605,99727,351,2954,12504,108,161,75,236,21,3,24,4,7,11,9,388,102.0,56.0
358,JHARKHAND,Palamu,24.196925968109337,84.20310842824594,1939869,1006302,355529,52375,933567,1024563,621706,402857,713175,803424,68238,473042,240133,2155,19981,51012,411,654,283,937,118,5,123,7,12,19,23,1515,108.0,53.0
359,JHARKHAND,Latehar,23.72511185840708,84.48298743362837,726978,369666,146377,14137,357312,350682,209706,140976,313379,349277,38194,180106,133273,340,6240,10697,146,238,100,338,47,2,49,3,5,8,7,547,103.0,48.0
362,JHARKHAND,Dumka,24.275006125574265,87.27662450229711,1321442,668514,303697,23281,652928,672409,406275,266134,624779,601078,62110,367108,257671,1193,10396,32443,376,574,244,818,90,4,94,6,10,16,18,1323,102.0,51.0
363,JHARKHAND,Jamtara,23.97873318077801,86.95325080091534,791042,404830,165555,20113,386212,426312,258260,168052,326631,366012,49419,214740,111891,808,4959,31194,150,234,101,335,39,2,41,3,4,7,8,540,105.0,54.0
364,JHARKHAND,Ranchi,23.184235061391547,85.31781937244203,2914253,1494937,420740,310242,1419316,1911433,1085244,826189,1142867,613855,350908,743967,398900,22538,76565,247137,674,1319,938,2257,351,58,409,81,131,212,253,3805,105.0,66.0
366,JHARKHAND,Gumla,23.078532948929148,84.55056787479396,1025213,514390,216629,16445,510823,559720,321795,237925,487508,322119,31687,264774,222734,831,7807,18701,242,370,155,525,59,3,62,4,6,10,10,849,101.0,55.0
367,JHARKHAND,Simdega,22.608760391198054,84.59193691931536,599578,300309,144169,11114,299269,343483,191991,151492,288645,191341,16865,159867,128778,423,4649,7606,148,214,92,306,26,2,28,3,5,8,7,496,100.0,57.0
371,ORISSA,Jharsuguda,21.827058566978184,83.93581682242987,579505,296690,103224,73962,282815,405879,228092,177787,247707,143508,81433,172018,75689,2498,7555,57831,157,265,194,459,70,71,141,34,55,89,26,870,105.0,70.0
372,ORISSA,Sambalpur,21.515752380952385,84.34958483245157,1041099,526877,220697,94798,514222,703691,393192,310499,505840,282248,126498,313161,192679,5231,14521,91058,282,454,356,810,125,137,262,41,66,107,88,1548,102.0,68.0
374,ORISSA,Sundargarh,22.06354819277107,84.50524819277099,2093437,1061147,387911,230151,1032290,1342322,750147,592175,873227,660465,223537,584687,288540,12787,35024,164585,564,943,713,1656,244,261,505,109,177,286,119,3130,103.0,64.0
376,ORISSA,Mayurbhanj,21.897621545157754,86.4030408052231,2519738,1256213,689110,64479,1263525,1369397,794171,575226,1223534,1094844,140189,697782,525752,2950,17999,83167,799,951,388,1339,269,232,501,29,48,77,31,2747,99.0,54.0
377,ORISSA,Baleshwar,21.48570932311624,87.08085828011933,2320529,1185787,601154,82440,1134742,1621232,902359,718873,932707,628627,296834,684020,248687,7370,28289,161266,728,889,420,1309,255,215,470,42,68,110,46,2664,104.0,70.0
378,ORISSA,Bhadrak,20.95262735257214,86.81496204516931,1506337,760260,373862,54244,746077,1094140,596269,497871,468599,323145,164636,409559,59040,2637,15609,86821,485,580,252,832,171,134,305,28,46,74,14,1711,102.0,73.0
379,ORISSA,Kendrapara,20.606319815982264,86.83763247572003,1440361,717814,414749,23494,722547,1089265,579970,509295,466890,294723,173107,386382,80508,1628,11836,96234,455,541,209,750,151,134,285,14,23,37,13,1540,99.0,76.0
381,ORISSA,Cuttack,20.407640646029623,85.7776810228802,2624470,1352760,579529,210768,1271710,2011469,1103033,908436,936365,472182,349587,761876,174489,15046,40589,236867,743,1167,851,2018,305,324,629,116,189,305,157,3852,106.0,77.0
383,ORISSA,Dhenkanal,20.79887159353349,85.53226836027711,1192811,612593,315390,36979,580218,829910,464093,365817,435533,341887,117172,340552,94981,1810,10600,66148,373,453,202,655,129,111,240,17,28,45,21,1334,106.0,70.0
385,ORISSA,Nayagarh,20.192895622119817,85.05614700460825,962789,502636,261646,26688,460153,688362,392333,296029,343633,232558,124984,284591,59042,1163,8278,50425,306,345,125,470,101,80,181,8,12,20,7,984,109.0,71.0
386,ORISSA,Khordha,20.054162322274863,85.52234834123229,2251673,1167137,331834,356895,1084536,1749936,957515,792421,792193,371244,349860,645880,146313,35701,75588,253754,550,1022,1105,2127,427,328,755,143,230,373,379,4186,108.0,78.0
387,ORISSA,Puri,19.83509174603177,85.86698989898981,1698730,865380,402014,72210,833350,1291939,704857,587082,621676,309790,201605,498461,123215,3416,16006,118112,515,663,347,1010,188,163,351,42,67,109,40,2027,104.0,76.0
388,ORISSA,Ganjam,19.2632617564534,84.80297710437702,3529031,1779218,795476,219918,1749813,2210050,1262652,947398,1501772,1055331,405298,990027,511745,9049,41059,257515,1066,1419,785,2204,396,357,753,97,158,255,99,4377,102.0,63.0
389,ORISSA,Gajapati,19.121080882352945,84.14015091911759,577817,282882,152095,23050,294935,262537,153663,108874,293933,335821,63112,155907,138026,635,5523,23672,193,198,88,286,68,38,106,10,16,26,9,617,96.0,45.0
390,ORISSA,Kandhamal,20.092878624813142,84.02216352765326,733110,359945,218446,24489,373165,399786,233900,165886,355349,287948,28736,193515,161834,768,6609,19477,251,238,93,331,85,42,127,8,12,20,9,739,96.0,55.0
394,ORISSA,Nuapada,20.47130951219512,82.59152536585364,610382,301962,197258,11869,308420,299383,180903,118480,305438,316086,43976,168155,137283,757,4221,21975,52,78,28,106,18,24,42,2,1,3,2,205,98.0,49.0
395,ORISSA,Kalahandi,19.784253092783523,83.1124043814433,1576869,787101,456336,38412,789768,802036,484177,317859,751930,765368,91171,447290,304640,1953,12622,58571,498,520,207,727,170,104,274,18,30,48,15,1562,100.0,51.0
396,ORISSA,Rayagada,19.292840020060204,83.45860120361095,967911,471960,237343,49205,495951,407735,241959,165776,467122,583140,61543,258032,209090,1553,9166,42998,290,356,172,528,104,82,186,21,34,55,15,1074,95.0,42.0
398,ORISSA,Koraput,18.82627794779476,82.81278469846964,1379647,678809,381789,78339,700838,568090,340843,227247,693406,770707,85766,384053,309353,3988,17294,60021,437,458,254,712,162,82,244,35,57,92,35,1519,97.0,41.0
399,ORISSA,Malkangiri,18.25227930367506,81.98293636363628,613192,303624,167884,15839,309568,244706,147001,97705,310666,390356,24604,170495,140171,448,3908,16397,176,192,75,267,59,42,101,6,10,16,5,564,98.0,40.0
400,CHHATTISGARH,Koriya,23.50412776859501,82.12515636363635,658917,334737,121852,59763,324180,397823,229923,167900,307071,179639,80023,185483,121588,1667,7609,38765,146,293,236,529,53,28,81,22,37,59,38,852,103.0,60.0
401,CHHATTISGARH,Surguja,23.32719278728607,83.23582493887531,2359886,1193129,525596,65167,1166757,1187941,694686,493255,1155807,991866,253131,649888,505919,2737,18983,74614,530,946,725,1671,159,22,181,17,28,45,36,2462,102.0,50.0
402,CHHATTISGARH,Jashpur,22.77286167664669,83.8703962075848,851669,424747,205670,20722,426922,495415,280656,214759,487360,328438,76783,263645,223715,567,5755,20512,196,342,246,588,46,5,51,4,7,11,11,856,99.0,58.0
403,CHHATTISGARH,Raigarh,22.008265068493166,83.27797698630134,1493984,750278,354278,66638,743706,951639,542756,408883,690167,460166,297308,429211,260956,3342,13857,98784,325,594,446,1040,82,27,109,21,34,55,45,1575,101.0,64.0
403,CHHATTISGARH,Raigarh,18.453257637845976,73.0090609418579,1493984,750278,354278,66638,743706,951639,542756,408883,690167,460166,297308,429211,260956,3342,13857,98784,325,594,446,1040,82,27,109,21,34,55,45,1575,101.0,64.0
520,MAHARASHTRA,Raigarh,22.008265068493166,83.27797698630134,2634200,1344345,581868,377160,1289855,1939994,1059692,880302,1072969,482420,547206,753843,319126,38570,96301,374021,279,1292,1881,3173,489,371,860,518,674,1192,592,6097,104.0,74.0
520,MAHARASHTRA,Raigarh,18.453257637845976,73.0090609418579,2634200,1344345,581868,377160,1289855,1939994,1059692,880302,1072969,482420,547206,753843,319126,38570,96301,374021,279,1292,1881,3173,489,371,860,518,674,1192,592,6097,104.0,74.0
404,CHHATTISGARH,Korba,22.491712499999995,82.57604326923074,1206640,612915,206598,126055,593725,748759,433391,315368,521186,410186,202380,333329,187857,4544,18004,95963,246,521,416,937,101,63,164,54,88,142,75,1565,103.0,62.0
409,CHHATTISGARH,Durg,21.194463849287164,81.33181639511197,3343872,1682101,533448,349741,1661771,2303378,1284612,1018766,1496805,823501,614109,921729,575076,16141,51289,343369,649,1369,1164,2533,233,173,406,135,219,354,266,4209,101.0,69.0
410,CHHATTISGARH,Raipur,20.88603153846152,82.20032759615388,4063872,2048186,673499,395001,2015686,2629749,1493158,1136591,1757664,1247434,728556,1099964,657700,20261,59523,378113,716,1465,1310,2775,263,161,424,131,195,326,320,4561,102.0,65.0
411,CHHATTISGARH,Mahasamund,21.223727037773354,82.65925427435384,1032754,511967,274793,35774,520787,637963,364089,273874,499260,384764,212487,291858,207402,961,5614,68012,232,404,238,642,14,17,31,14,23,37,20,964,98.0,62.0
412,CHHATTISGARH,Dhamtari,20.554912627291245,81.7569195519348,799781,397897,168689,41792,401884,546833,303924,242909,402895,214637,148926,226382,176513,1016,4804,67737,198,322,174,496,12,17,29,13,21,34,26,782,99.0,68.0
414,CHHATTISGARH,Bastar,19.393866751269048,81.52895126903546,1413199,698487,316425,54894,714712,650863,382335,268528,726531,729550,157646,404364,322167,1782,9042,50155,353,622,406,1028,47,22,69,17,27,44,36,1529,98.0,46.0
417,CHHATTISGARH,Bijapur,16.84015316666667,75.95909166666665,255230,128663,50449,7942,126567,86919,54076,32843,134525,163278,12516,71591,62934,117,1462,4215,293,528,383,911,71,23,94,19,30,49,40,1387,102.0,34.0
557,KARNATAKA,Bijapur,16.84015316666667,75.95909166666665,2177331,1111022,396449,131041,1066309,1248268,730566,517702,927722,746979,326594,580111,347611,4987,36571,164015,447,860,643,1503,217,163,380,228,293,521,89,2938,104.0,57.0
418,MADHYA PRADESH,Sheopur,25.78014810996563,77.16911116838484,687861,361784,150146,26376,326077,328025,208201,119824,277455,393141,74770,183788,93667,273,5393,29266,156,289,174,463,10,14,24,12,20,32,16,693,111.0,48.0
419,MADHYA PRADESH,Morena,26.37313504531724,77.88447341389724,1965970,1068417,319298,95288,897553,1179685,747652,432033,675993,706917,131486,525329,150664,1781,20172,89156,473,789,380,1169,40,55,95,47,76,123,66,1924,119.0,60.0
420,MADHYA PRADESH,Bhind,26.35951126187245,78.7618324287653,1703005,926843,271211,88385,776162,1094917,676513,418404,520768,388473,107819,455775,64993,1166,14368,75539,379,712,411,1123,44,57,101,52,84,136,47,1786,119.0,64.0
421,MADHYA PRADESH,Gwalior,26.04074441964285,78.12782433035713,2032036,1090327,172720,272172,941709,1357210,803114,554096,685311,554486,306859,548820,136491,15779,46454,232840,330,797,823,1620,147,153,300,129,201,330,249,2830,116.0,67.0
422,MADHYA PRADESH,Datia,25.90226439560441,78.63916571428574,786754,420157,160453,43401,366597,491445,303815,187630,321160,260076,97696,225662,95498,616,5251,55966,202,385,237,622,19,25,44,22,36,58,25,951,115.0,62.0
423,MADHYA PRADESH,Shivpuri,25.37802451874367,77.74861600810549,1726050,919795,367859,66759,806255,900846,573242,327604,759281,719547,148128,481001,278280,1852,15304,71501,407,750,454,1204,30,42,72,35,58,93,52,1827,114.0,52.0
424,MADHYA PRADESH,Tikamgarh,25.14099852104666,78.89357064846428,1445166,760355,322772,60220,684811,747940,459353,288587,655318,659348,132725,402776,252542,1090,10899,62828,328,630,429,1059,50,35,85,31,51,82,36,1591,111.0,52.0
425,MADHYA PRADESH,Chhatarpur,24.813637376460004,79.56449299191374,1762375,936121,375869,95048,826254,943033,572010,371023,751797,770268,176056,481518,270279,1880,15567,82967,413,771,468,1239,42,58,100,50,81,131,64,1947,113.0,54.0
426,MADHYA PRADESH,Panna,24.451325840092657,80.21133001158752,1016520,533480,256744,32179,483040,552559,332140,220419,431998,427997,76097,275375,156623,653,8501,30800,238,438,269,707,12,17,29,14,23,37,23,1034,110.0,54.0
427,MADHYA PRADESH,Sagar,23.800318709677374,78.71940357771273,2378458,1256257,448408,165507,1122201,1545719,908607,637112,1006035,711804,366494,682077,323958,4546,24811,160622,525,1037,716,1753,67,95,162,80,129,209,123,2771,112.0,65.0
428,MADHYA PRADESH,Damoh,23.76624407960196,79.47049303482588,1264219,661873,303387,66514,602346,747715,445737,301978,574595,469038,187731,367711,206884,1432,10504,66044,287,547,354,901,26,33,59,29,46,75,36,1359,110.0,59.0
429,MADHYA PRADESH,Satna,24.62777621776502,80.75547048710598,2228935,1157495,461831,114173,1071440,1371781,801051,570730,911349,715509,294702,590487,320862,3754,22751,117176,487,963,766,1729,130,66,196,55,89,144,86,2641,108.0,62.0
430,MADHYA PRADESH,Rewa,24.861184625158856,81.57572465057183,2365106,1225100,523910,94489,1140006,1441757,845572,596185,991946,766166,251132,617184,374762,3406,31194,109351,511,1000,831,1831,154,55,209,46,72,118,86,2756,107.0,61.0
431,MADHYA PRADESH,Umaria,23.59601063063061,80.90879477477475,644758,330674,138100,29966,314084,356672,210907,145765,289691,230782,67975,175698,113993,839,6360,22502,128,250,209,459,42,14,56,11,19,30,19,692,105.0,55.0
432,MADHYA PRADESH,Neemuch,24.70311893333336,75.06608186666664,826067,422653,174235,67962,403414,508834,307889,200945,418682,289113,145258,245708,172974,1945,8342,73279,182,367,291,658,46,32,78,26,43,69,41,1026,105.0,62.0
433,MADHYA PRADESH,Mandsaur,24.19278764044944,75.43588667736759,1340411,682851,302287,81832,657560,834591,502898,331693,679723,467002,239885,397714,282009,2324,12507,109904,326,600,368,968,24,35,59,29,46,75,47,1475,104.0,62.0
434,MADHYA PRADESH,Ratlam,23.503562290502792,75.14895782122909,1455069,738241,266716,107151,716828,825880,485090,340790,690980,622153,213825,411446,279534,3644,14905,107463,318,631,448,1079,40,58,98,47,77,124,81,1700,103.0,57.0
435,MADHYA PRADESH,Ujjain,23.319288862745065,75.80383717647058,1986864,1016289,300765,188684,970575,1240990,730817,510173,897442,659279,323379,569425,328017,7501,27733,181659,417,879,721,1600,103,106,209,87,142,229,145,2599,105.0,62.0
436,MADHYA PRADESH,Shajapur,23.566620317220547,76.33555181268885,1512681,780520,312611,73997,732161,894612,543509,351103,717871,544791,232735,431857,286014,1382,10797,88946,351,671,423,1094,37,39,76,36,58,94,33,1647,107.0,59.0
437,MADHYA PRADESH,Dewas,22.7851110021322,76.46088805970157,1563715,805359,274995,101014,758356,925369,550716,374653,742676,565365,270457,451501,291175,3518,16523,124826,334,679,531,1210,86,61,147,52,84,136,73,1899,106.0,59.0
438,MADHYA PRADESH,Dhar,22.57268171896316,75.1105620736698,2185793,1112725,412348,103364,1073068,1077338,638479,438859,1027974,1021851,349639,597079,430895,2388,18626,123750,453,897,729,1626,144,56,200,47,77,124,66,2470,104.0,49.0
439,MADHYA PRADESH,Indore,22.680265752128648,75.9133801324502,3276697,1699627,200371,587947,1577070,2309130,1289631,1019499,1268195,718174,593576,939055,329140,48691,111478,464337,539,1438,1696,3134,456,323,779,292,424,716,615,5783,108.0,70.0
441,MADHYA PRADESH,Barwani,21.702135714285724,74.91004719710673,1385881,699340,250358,48912,686541,549926,313642,236284,653897,825034,181139,365928,287969,1158,8516,48847,315,561,321,882,19,26,45,22,36,58,35,1336,102.0,40.0
442,MADHYA PRADESH,Rajgarh,23.785499026425583,76.66431223922116,1545814,790212,331894,69823,755602,804245,488797,315448,745603,706958,231130,429768,315835,1611,12718,76942,341,652,436,1088,53,35,88,32,52,84,30,1629,105.0,52.0
443,MADHYA PRADESH,Vidisha,23.82838307984792,77.9013507604563,1458875,769568,292579,83830,689307,862918,512344,350574,550402,512311,181510,401583,148819,1926,12888,96565,332,631,395,1026,32,44,76,38,62,100,48,1583,112.0,59.0
444,MADHYA PRADESH,Bhopal,23.480726143790854,77.39246623093679,2371061,1236130,118893,581826,1134931,1660690,920314,740376,867457,462581,452912,644960,222497,40788,94729,339750,354,977,1211,2188,418,238,656,237,312,549,552,4298,109.0,70.0
445,MADHYA PRADESH,Sehore,22.9297199679658,77.06780202883085,1311332,683743,270427,59220,627589,780362,469208,311154,586087,508396,212138,364559,221528,1566,11166,100011,293,564,395,959,50,32,82,28,45,73,35,1442,109.0,60.0
446,MADHYA PRADESH,Raisen,23.292518206521724,78.16305495923909,1331597,700358,251272,74441,631239,820220,479093,341127,517838,444877,194373,370366,147472,1141,9931,87258,311,596,368,964,30,37,67,34,55,89,28,1460,111.0,62.0
447,MADHYA PRADESH,Betul,21.96462631578948,77.7873428189117,1575362,799236,318945,87704,776126,939769,529783,409986,786980,603098,230974,453887,333093,2109,13755,94586,344,678,541,1219,103,40,143,34,56,90,47,1845,103.0,60.0
448,MADHYA PRADESH,Harda,22.227659781121783,77.07022571819435,570465,294838,112714,31845,275627,352550,203807,148743,230979,177731,95066,156852,74127,986,5376,45661,128,240,159,399,14,16,30,14,21,35,28,619,107.0,62.0
449,MADHYA PRADESH,Hoshangabad,22.595268801996703,78.02168094841929,1241350,648725,209650,105746,592625,810644,469199,341445,478082,344492,198076,345435,132647,2871,14456,112371,276,559,410,969,44,55,99,46,75,121,70,1535,109.0,65.0
450,MADHYA PRADESH,Katni,23.724416229116937,80.33819665871127,1292042,662013,276151,72880,630029,790773,460583,330190,543874,465374,172416,348410,195464,2179,13094,76207,266,528,437,965,79,36,115,30,48,78,52,1476,105.0,61.0
451,MADHYA PRADESH,Jabalpur,23.18525572327043,79.98328754716981,2463289,1277278,272284,352477,1186011,1756468,980307,776161,1005624,540029,452023,705970,299654,20443,58601,285248,471,1105,1084,2189,171,199,370,167,261,428,318,3776,108.0,71.0
453,MADHYA PRADESH,Dindori,22.83738437047757,81.04332966714911,704524,351913,218021,9774,352611,378714,222759,155955,389925,295655,62372,203383,186542,554,6447,13765,151,274,185,459,21,4,25,4,5,9,7,652,100.0,54.0
454,MADHYA PRADESH,Mandla,22.70348712446353,80.38600543633753,1054905,525272,279674,37258,529633,604962,348033,256929,559649,376944,143803,300235,259414,912,9042,40591,230,427,290,717,29,15,44,12,19,31,20,1043,99.0,57.0
455,MADHYA PRADESH,Chhindwara,22.227966971713823,78.76413136439254,2090922,1064468,413142,140802,1026454,1294198,731294,562904,957984,663446,344875,582263,375721,3588,20034,138316,455,914,704,1618,117,73,190,63,103,166,83,2513,104.0,62.0
456,MADHYA PRADESH,Seoni,22.33230487804874,79.66053863928111,1379131,695879,335045,47542,683252,864194,485341,378853,684434,458811,228695,394660,289774,1182,10417,66919,306,567,375,942,30,20,50,16,27,43,28,1369,102.0,63.0
457,MADHYA PRADESH,Balaghat,21.80020720640569,80.42170053380796,1701698,842178,400074,70793,859520,1147623,626468,521155,893014,493415,277927,488610,404404,1712,13306,82475,347,668,472,1140,68,35,103,32,51,83,35,1709,98.0,67.0
458,MADHYA PRADESH,Guna,24.49043927178156,77.2235895968791,1241519,649362,212765,72320,592157,653980,400537,253443,514897,578034,144248,335454,179443,2482,11740,80642,254,498,347,845,33,38,71,32,52,84,48,1302,110.0,53.0
459,MADHYA PRADESH,Ashoknagar,24.63098846153845,77.82974493927134,845071,443837,169606,37135,401234,469109,290304,178805,315270,359525,84720,231829,83441,619,6016,42898,176,337,238,575,27,18,45,15,24,39,24,861,111.0,56.0
460,MADHYA PRADESH,Shahdol,23.44859864559819,81.4596831828442,1066063,540021,233594,57846,526042,604194,348761,255433,493057,422736,113184,292402,200655,1733,10817,45685,206,451,330,781,64,60,124,55,90,145,45,1302,103.0,57.0
461,MADHYA PRADESH,Anuppur,23.18184220430107,81.86560000000007,749237,379114,147388,60325,370123,436595,254120,182475,346471,271733,81338,207401,139070,1290,7266,41067,166,307,243,550,52,3,55,3,4,7,8,787,102.0,58.0
462,MADHYA PRADESH,Sidhi,24.17547189952905,82.1053783359498,1127033,575912,250953,25916,551121,600785,353030,247755,461760,477472,102228,284289,177471,837,10790,26502,493,1007,933,1940,212,76,288,66,100,166,131,3019,104.0,53.0
464,MADHYA PRADESH,Jhabua,22.419578015397768,74.40921616766468,1025048,515023,211080,24713,510025,352081,214582,137499,515121,775664,125411,265489,249632,744,5591,22470,398,706,403,1109,13,20,33,16,26,42,30,1612,101.0,34.0
467,MADHYA PRADESH,Burhanpur,21.364567254408065,76.24460478589425,757847,388504,115979,62861,369343,408679,233073,175606,328339,317962,112420,211925,116414,986,5058,58527,160,342,265,607,52,39,91,36,58,94,35,989,105.0,54.0
468,GUJARAT,Kachchh,23.48057203301311,68.82192301497916,2092371,1096737,488293,250982,995634,1252319,739239,513080,776228,581952,403294,624704,151524,9631,31961,250397,197,729,1297,2026,513,277,790,219,306,525,608,4146,110.0,60.0
469,GUJARAT,Banas Kantha,24.258538965517253,71.93205252873561,3120506,1610379,666773,137424,1510127,1704923,1048402,656521,1248600,1207376,396873,836268,412332,3424,23149,144792,479,1420,1077,2497,205,273,478,296,388,684,103,4242,107.0,55.0
470,GUJARAT,Patan,23.80634198473284,71.75162977099237,1343734,694397,301483,102655,649337,837913,494631,343282,554830,452891,223424,383074,171756,2231,12870,108006,205,654,584,1238,125,160,285,151,231,382,89,2199,107.0,62.0
471,GUJARAT,Mahesana,23.529355452865065,72.45545194085031,2035064,1056520,476005,183738,978544,1502645,847499,655146,812064,434497,385609,588699,223365,7759,33731,245131,296,1004,1012,2016,220,268,488,226,369,595,252,3648,108.0,74.0
472,GUJARAT,Sabar Kantha,23.71803594548552,73.13638790459964,2428589,1244231,544024,121509,1184358,1578734,918625,660109,1084878,665058,438606,681435,403443,5262,25425,180909,395,1265,1082,2347,175,239,414,249,406,655,126,3934,105.0,65.0
473,GUJARAT,Gandhinagar,23.19367979002625,72.67221679790026,1391753,723864,237624,195634,667889,1030494,582686,447808,534976,246993,262539,408075,126901,12107,33662,178594,460,1535,1645,3180,389,515,904,403,656,1059,413,6016,108.0,74.0
474,GUJARAT,Ahmadabad,22.605425564971743,72.23898135593227,7214225,3788051,353169,1845383,3426174,5435760,3025463,2410297,2594952,1129562,1456046,2127547,467405,126341,273651,1159650,614,2501,5241,7742,1733,2376,4109,1237,2022,3259,2909,18633,111.0,75.0
475,GUJARAT,Surendranagar,22.82672007299272,71.48358740875906,1756268,909917,340788,159810,846351,1093626,643221,450405,723500,493427,302068,504038,219462,2975,15309,177591,286,923,854,1777,201,248,449,225,348,573,143,3227,108.0,62.0
476,GUJARAT,Rajkot,22.40603377715488,70.83679439383323,3804558,1974445,459474,721532,1830113,2725056,1514075,1210981,1479050,738660,747352,1159480,319570,21785,67370,571843,455,1709,2322,4031,734,866,1600,576,942,1518,894,8498,108.0,72.0
477,GUJARAT,Jamnagar,22.410600414263328,69.62062005768233,2160119,1114192,347158,299167,1045927,1396534,795140,601394,847440,502873,386538,646822,200618,11573,30384,270555,268,1037,1384,2421,478,469,947,323,528,851,541,5028,107.0,65.0
478,GUJARAT,Porbandar,21.55092351651571,69.71896987722886,585449,300209,96015,87557,285240,393678,221621,172057,231169,137119,117040,174118,57051,1653,5639,80820,74,284,410,694,127,146,273,89,146,235,187,1463,105.0,67.0
479,GUJARAT,Junagadh,20.72568199498111,70.83985639899612,2743082,1404356,489237,287506,1338726,1842818,1046981,795837,1123709,669022,498326,801859,321850,6628,26991,318954,419,1460,1516,2976,383,437,820,364,595,959,374,5549,105.0,67.0
479,GUJARAT,Junagadh,20.929523011609785,70.54733890140345,2743082,1404356,489237,287506,1338726,1842818,1046981,795837,1123709,669022,498326,801859,321850,6628,26991,318954,419,1460,1516,2976,383,437,820,364,595,959,374,5549,105.0,67.0
480,GUJARAT,Amreli,21.04832649310872,71.43457637825426,1514190,771049,313714,116899,743141,995459,558180,437279,657139,380595,273331,453642,203497,2538,12765,164282,225,788,768,1556,198,199,397,179,293,472,176,2825,104.0,66.0
481,GUJARAT,Bhavnagar,21.70219390341736,72.16272632761141,2880365,1490201,387251,356826,1390164,1887255,1087371,799884,1150632,508664,500757,838781,311851,7297,28925,293361,359,1270,1490,2760,403,495,898,366,599,965,452,5434,107.0,66.0
482,GUJARAT,Anand,22.282718206229863,72.57782051557454,2092745,1087224,413078,208909,1005521,1551253,874481,676772,844794,360506,378310,627561,217233,9902,32523,203467,261,953,1293,2246,393,314,707,250,368,618,538,4372,108.0,74.0
483,GUJARAT,Kheda,22.88765312500002,73.018803515625,2299885,1185727,461479,160547,1114158,1660243,942480,717763,933983,482078,372226,674586,259397,5710,24502,171342,320,1146,1169,2315,320,293,613,242,394,636,370,4252,106.0,72.0
484,GUJARAT,Panch Mahals,22.80435606837605,73.61984598290586,2390776,1226961,463363,104238,1163815,1440805,858054,582751,1097507,781582,398937,673565,423942,3456,19753,90896,395,1263,1083,2346,189,252,441,257,420,677,121,3981,105.0,60.0
486,GUJARAT,Vadodara,22.26133739279589,73.49433010291594,4165626,2153736,547454,692971,2011890,2893080,1614087,1278993,1693473,910219,798277,1233312,460161,53606,117818,497049,473,1780,2837,4617,889,924,1813,584,905,1489,1360,9753,107.0,69.0
487,GUJARAT,Narmada,21.70666386292833,73.68403208722742,590297,301086,138121,22248,289211,370336,211767,158569,294795,192780,101940,174282,120513,576,4081,31194,100,321,268,589,43,57,100,62,102,164,25,979,104.0,63.0
488,GUJARAT,Bharuch,21.75787276237761,72.67326346710801,1551019,805707,300677,181319,745312,1118276,623047,495229,627124,273829,309091,468919,158205,10257,29531,178535,213,782,922,1704,282,236,518,180,293,473,336,3242,108.0,72.0
489,GUJARAT,The Dangs,20.801633877551023,73.6883518367347,228291,113821,52102,7516,114470,140968,77314,63654,118257,91160,29794,61329,56928,137,1393,9262,43,124,82,206,11,16,27,22,27,49,0,325,99.0,62.0
490,GUJARAT,Navsari,20.866973318871995,72.86184869848157,1329672,678165,267739,141417,651507,1001909,539471,462438,591834,261956,267679,407881,183953,6726,24397,153431,164,612,1019,1631,384,225,609,159,252,411,442,3256,104.0,75.0
491,GUJARAT,Valsad,20.44238231644259,72.9148584798345,1705678,887222,262410,235981,818456,1170657,655528,515129,743245,405928,329218,516188,227057,11020,31285,188248,223,817,911,1728,269,260,529,196,318,514,325,3316,108.0,69.0
492,GUJARAT,Surat,21.25761372772093,72.93488716344339,6081322,3402224,369840,1529998,2679098,4571410,2687468,1883942,2553542,942150,1252452,2142819,410723,55694,149331,788447,712,2970,4428,7398,1780,1700,3480,1170,1924,3094,1684,16368,127.0,75.0
495,DAMAN AND DIU,Daman,20.43161666666668,72.8392366071429,191173,124659,10006,61073,66514,150348,104316,46032,105521,20641,49249,94502,11019,1316,4543,28433,893,3631,7152,10783,4285,2444,6729,3382,4461,7843,7897,34145,187.0,79.0
497,MAHARASHTRA,Nandurbar,21.523175625248147,74.32638757443429,1648295,833170,333440,71572,815125,906509,512099,394410,792065,790613,186202,442898,349167,2579,17047,83144,264,950,449,1399,144,210,354,207,224,431,0,2446,102.0,55.0
498,MAHARASHTRA,Dhule,21.27401869040052,74.58719071837263,2050862,1054031,382777,146013,996831,1293916,723388,570528,936370,649568,315332,570448,365922,6065,27139,174524,292,1133,794,1927,208,305,513,372,478,850,0,3583,106.0,63.0
499,MAHARASHTRA,Jalgaon,20.8828943415638,75.55140421810695,4229917,2197365,796223,373565,2032552,2891882,1629223,1262659,1863571,1003050,720791,1186472,677099,14297,56775,431221,614,2393,1790,4183,471,687,1158,847,1122,1969,65,7988,108.0,68.0
500,MAHARASHTRA,Buldana,20.56680611183355,76.39017880364096,2586258,1337560,575405,152787,1248698,1879874,1048892,830982,1219641,600436,423036,734024,485617,4767,24877,225282,406,1531,910,2441,262,383,645,430,499,929,0,4421,107.0,73.0
501,MAHARASHTRA,Akola,20.746310479041902,77.12122320359276,1813906,932334,308158,196077,881572,1411281,758977,652304,768154,352687,314490,520362,247792,6163,24232,176674,270,1059,871,1930,255,372,627,442,679,1121,0,3948,106.0,78.0
502,MAHARASHTRA,Washim,20.282282394366213,77.25502394366208,1197160,620302,274925,55921,576858,869917,487703,382214,569792,291525,196022,340353,229439,1875,10757,97022,190,714,387,1101,115,167,282,181,188,369,0,1942,108.0,73.0
503,MAHARASHTRA,Amravati,21.16520991810736,77.67583503184723,2888445,1480768,508921,272894,1407677,2251875,1207104,1044771,1236322,478074,512492,837577,398745,9438,36185,302188,404,1683,1512,3195,369,540,909,692,1036,1728,0,6236,105.0,78.0
504,MAHARASHTRA,Wardha,20.80743024390242,78.57259105691062,1300774,668385,268486,120218,632389,1019458,552617,466841,608235,212054,266155,392316,215919,4313,16260,170620,184,799,711,1510,141,207,348,276,334,610,99,2754,106.0,78.0
505,MAHARASHTRA,Nagpur,21.196556862745105,79.02166176470584,4653570,2384975,430844,877522,2268595,3673808,1959220,1714588,1868560,601547,917626,1334211,534349,57964,135750,728714,491,2153,3484,5637,1071,1134,2205,1575,1780,3355,2385,14073,105.0,79.0
506,MAHARASHTRA,Bhandara,21.211792649727748,80.10950199637024,1200334,605520,283843,72575,594814,899860,488709,411151,597305,235524,227025,345054,252251,2932,13165,117299,175,748,579,1327,105,152,257,209,167,376,102,2237,102.0,75.0
507,MAHARASHTRA,Gondiya,21.225008411215,80.17522698598128,1322507,661554,319702,66813,660953,1004243,542837,461406,665419,256549,239981,383151,282268,2866,13595,104997,201,806,515,1321,106,154,260,213,109,322,79,2183,100.0,76.0
509,MAHARASHTRA,Chandrapur,20.095609090909075,79.31556380471388,2204307,1123834,451324,233331,1080473,1578615,872565,706050,1058172,516728,418666,648565,409607,8239,31419,229635,304,1327,1306,2633,285,417,702,541,860,1401,44,5085,104.0,72.0
510,MAHARASHTRA,Yavatmal,20.04258346738159,78.05326371760479,2772348,1419965,629243,168889,1352383,2022574,1115980,906594,1355999,718204,446516,815475,540524,6094,29917,245261,436,1695,1094,2789,272,398,670,493,508,1001,39,4937,105.0,73.0
511,MAHARASHTRA,Nanded,19.209316983017,77.6829048951049,3361292,1730075,591119,230563,1631217,2189425,1255222,934203,1493953,884626,488748,925232,568721,7548,43055,216364,525,1986,1321,3307,365,535,900,622,781,1403,79,6214,106.0,65.0
512,MAHARASHTRA,Hingoli,19.59525302245251,77.09239412780653,1177345,606294,242456,41913,571051,790743,450551,340192,569182,331388,159114,330903,238279,1221,9676,73640,180,676,384,1060,105,153,258,174,182,356,0,1853,106.0,67.0
513,MAHARASHTRA,Parbhani,19.31032425249168,76.70163338870431,1836086,942870,293480,133759,893216,1157814,666291,491523,822797,552643,272486,501422,321375,3982,21196,135933,254,982,730,1712,219,321,540,370,534,904,0,3410,106.0,63.0
514,MAHARASHTRA,Jalna,19.984612534818933,75.98473607242339,1959046,1011473,404746,98084,947573,1195523,699428,496095,930886,545980,288895,545030,385856,3791,17236,158182,265,1105,827,1932,178,259,437,340,388,728,0,3363,107.0,61.0
516,MAHARASHTRA,Nashik,20.266912871287143,74.03824168316828,6107187,3157186,904661,764271,2950001,4345366,2397538,1947828,2763328,1481778,904710,1746286,1017042,45039,138887,630639,805,3303,3299,6602,792,1158,1950,1534,1975,3509,764,13629,107.0,71.0
517,MAHARASHTRA,Thane,19.698767747440264,72.79882742564581,11060148,5865078,713994,2904157,5195070,8227161,4591396,3635765,4492767,1692022,2231800,3363123,1129644,256170,551643,1741244,1175,4956,8527,13483,2404,3097,5501,4199,5195,9394,5565,35118,113.0,74.0
521,MAHARASHTRA,Pune,18.51696171428573,74.12922881632647,9429408,4924105,1165718,2056739,4505303,7171723,3940210,3231513,4048993,1353077,1925019,2809816,1239177,235018,490260,1555272,905,3929,6261,10190,2831,1949,4780,2727,3272,5999,5349,27223,109.0,76.0
523,MAHARASHTRA,Bid,18.952353340080982,75.69319706477731,2585049,1349106,563114,135457,1235943,1718507,987185,731322,1255548,821607,402052,727819,527729,5614,29198,205352,396,1502,881,2383,234,342,576,398,415,813,10,4179,109.0,66.0
524,MAHARASHTRA,Latur,18.348687268993856,76.75812607802874,2454196,1273140,428616,157016,1181056,1650672,932432,718240,1046857,596213,381722,670018,376839,6217,29758,190739,373,1448,1012,2460,267,389,656,474,609,1083,0,4574,108.0,67.0
525,MAHARASHTRA,Osmanabad,18.19459456066944,75.99495575313809,1657576,861535,367158,77832,796041,1137810,644304,493506,773916,440363,240042,473795,300121,3209,18183,117741,262,1008,606,1614,150,219,369,267,233,500,40,2786,108.0,69.0
526,MAHARASHTRA,Solapur,17.837357937584812,75.42394823609216,4317756,2227852,779929,376302,2089904,2910676,1651266,1259410,1898395,976795,595560,1206933,691462,15145,59296,376000,627,2539,2095,4634,543,794,1337,1013,1384,2397,0,8995,107.0,67.0
527,MAHARASHTRA,Satara,17.6737908974359,74.18052064102558,3003741,1510842,774522,200949,1492899,2225694,1201034,1024660,1354947,545423,562653,844805,510142,14093,57423,374085,437,1881,1461,3342,280,374,654,517,366,883,334,5649,101.0,74.0
528,MAHARASHTRA,Ratnagiri,17.210195070127703,73.25725893866404,1615069,761121,538538,100824,853948,1199392,619012,580380,714076,319622,367352,407008,307068,7752,31062,163470,233,1106,1009,2115,173,198,371,278,283,561,202,3484,89.0,74.0
529,MAHARASHTRA,Sindhudurg,16.170948049777163,73.51329008172343,849651,417332,295847,44989,432319,666067,348289,317778,347178,121922,194228,229676,117502,3517,15721,98475,107,508,563,1071,117,89,206,124,157,281,85,1749,97.0,78.0
530,MAHARASHTRA,Kolhapur,16.44881301587301,74.12897150793648,3876001,1980658,796496,382818,1895343,2825845,1559760,1266085,1704054,778000,770005,1125204,578850,22269,71879,507573,530,2257,2144,4401,451,659,1110,884,1016,1900,525,8464,105.0,73.0
531,MAHARASHTRA,Sangli,17.154930181086502,74.70713822937628,2822143,1435728,626872,226801,1386415,2049467,1121550,927917,1215104,579039,485126,800214,414890,13212,49056,310230,409,1689,1418,3107,313,435,748,595,496,1091,442,5798,104.0,73.0
532,ANDHRA PRADESH,Adilabad,19.284513950073435,78.81321233480176,2741239,1369597,597466,220248,1371642,1483347,856350,626997,1323667,1030640,566108,748939,574728,5512,45202,306433,648,1604,1266,2870,84,122,206,134,213,347,109,4181,100.0,54.0
533,ANDHRA PRADESH,Nizamabad,18.429485849056604,78.07523490566035,2551335,1250641,565165,155133,1300694,1389810,790214,599596,1261076,1041862,545913,684320,576756,5261,35036,308270,661,1468,931,2399,61,60,121,71,105,176,100,3458,96.0,54.0
534,ANDHRA PRADESH,Karimnagar,18.515483193277312,79.43765428571413,3776269,1880800,877236,288044,1895469,2206829,1257238,949591,1876768,1280393,926768,1049463,827305,8831,46584,589283,961,2163,1420,3583,128,99,227,119,173,292,186,5251,99.0,58.0
535,ANDHRA PRADESH,Medak,17.889304978038055,78.13778901903379,3033288,1523030,593653,195479,1510258,1637137,953406,683731,1442203,1199818,604719,837874,604329,8635,47170,349304,786,1659,997,2656,84,59,143,71,102,173,116,3874,101.0,54.0
536,ANDHRA PRADESH,Hyderabad,17.38971555555556,78.46668888888888,3943323,2018575,0,1066289,1924748,2892155,1542688,1349467,1413297,556902,869721,1045585,367712,149034,274653,746818,416,2008,3204,5212,1708,494,2202,671,860,1531,1710,11071,105.0,73.0
538,ANDHRA PRADESH,Mahbubnagar,16.639546224256293,77.98933089244859,4053028,2050386,848963,161052,2002642,1940646,1158386,782260,2082501,1604319,757821,1140067,942434,6153,60812,362791,1068,2104,1137,3241,70,54,124,65,95,160,102,4695,102.0,48.0
539,ANDHRA PRADESH,Nalgonda,17.113250515463907,79.16984453608244,3488809,1759772,833504,197433,1729037,2001019,1160757,840262,1741693,1294811,789225,976428,765265,7715,53777,464172,968,1937,1106,3043,64,72,136,84,125,209,113,4468,102.0,57.0
540,ANDHRA PRADESH,Warangal,18.01752608695651,79.87422028985509,3512576,1759281,758738,288249,1753295,2065023,1179790,885233,1705655,1191252,828077,960926,744729,12952,59006,462819,938,1936,1203,3139,135,93,228,112,162,274,185,4762,100.0,59.0
541,ANDHRA PRADESH,Khammam,17.683921325051784,80.67008643892335,2797370,1390988,669262,201363,1406382,1630234,901640,728594,1410062,875272,668519,802906,607156,8628,42171,416734,732,1584,1012,2596,75,78,153,92,136,228,127,3836,99.0,58.0
542,ANDHRA PRADESH,Srikakulam,18.570900998697432,84.25874814010675,2703114,1341738,752752,149684,1361376,1495381,857824,637557,1290288,1009992,615432,766483,523805,3988,32280,297418,743,1475,803,2278,58,37,95,45,64,109,76,3301,99.0,55.0
543,ANDHRA PRADESH,Vizianagaram,18.28329696032972,83.45982854198873,2344474,1161477,592458,157056,1182997,1238388,707503,530885,1157962,1031683,527736,679289,478673,4453,24128,278230,613,1306,804,2110,45,65,110,74,114,188,81,3103,98.0,53.0
545,ANDHRA PRADESH,East Godavari,16.782718320784902,82.2432074720511,5154296,2569688,1199479,406362,2584608,3288577,1716933,1571644,2093681,1524603,1297273,1545831,547850,22411,93784,821421,1274,2865,1949,4814,189,164,353,195,286,481,290,7211,99.0,64.0
546,ANDHRA PRADESH,West Godavari,16.63297943925236,81.45912990654196,3936966,1964918,1007255,248373,1972048,2652389,1379223,1273166,1773112,1028767,1017568,1199338,573774,12050,55613,648607,1011,2260,1477,3737,131,105,236,126,184,310,193,5485,100.0,67.0
547,ANDHRA PRADESH,Krishna,16.143872753151673,81.14805061000413,4517398,2267375,909292,567042,2250023,3009718,1598959,1410759,2048880,1352499,1163932,1327299,721581,30438,101450,794346,1054,2557,2029,4586,270,180,450,218,313,531,364,6983,101.0,67.0
548,ANDHRA PRADESH,Guntur,15.884925767634847,80.58657614107885,4887813,2440521,1069877,513113,2447292,2960441,1634726,1325715,2381624,1474349,1186028,1442370,939254,19383,80434,816849,1119,2657,1953,4610,196,188,384,222,328,550,317,6981,100.0,61.0
549,ANDHRA PRADESH,Prakasam,15.489039001601704,80.11665790176184,3397448,1714764,873486,214089,1682684,1904435,1107686,796749,1700567,1218310,763746,991842,708725,6151,43611,468022,855,1845,1128,2973,91,65,156,79,114,193,127,4304,102.0,56.0
552,ANDHRA PRADESH,Kurnool,15.43759715142429,77.90086836581717,4053463,2039227,783853,306982,2014236,2127161,1246369,880792,2029425,1517933,816721,1164122,865303,10081,56478,543044,1042,2163,1355,3518,108,114,222,134,199,333,185,5301,101.0,52.0
553,ANDHRA PRADESH,Anantapur,14.312065561843148,77.4601584478577,4081148,2064495,902997,341431,2016653,2310960,1338474,972486,2036166,1369069,897970,1208544,827622,8606,48299,559461,969,2252,1605,3857,143,150,293,176,261,437,243,5799,102.0,57.0
554,ANDHRA PRADESH,Chittoor,13.33109263067696,78.92763898886037,4174064,2090204,907970,395900,2083860,2667878,1484794,1183084,1933357,1170993,944555,1202223,731134,13763,67087,611465,1021,2270,1565,3835,261,125,386,157,218,375,307,5926,100.0,64.0
555,KARNATAKA,Belgaum,16.16107219152853,74.72329042357275,4779661,2423063,962777,356198,2356598,3052032,1725548,1326484,2105668,1346776,808827,1372422,733246,17560,73497,468274,1016,1973,1572,3545,592,373,965,521,691,1212,308,7045,103.0,64.0
556,KARNATAKA,Bagalkot,16.15860676328503,75.64526070853468,1889752,950111,324799,165858,939641,1113412,641388,472024,818081,608843,301389,511575,306506,3745,26297,161280,380,811,694,1505,217,155,372,217,327,544,89,2890,101.0,59.0
558,KARNATAKA,Bidar,17.950361730769224,77.19459961538459,1703300,870665,287134,102269,832635,1042673,597198,445475,702608,515395,271439,459050,243558,3971,36072,116314,377,735,529,1264,168,143,311,201,246,447,50,2448,105.0,61.0
559,KARNATAKA,Raichur,16.050795353982295,76.87368606194688,1928812,964511,330446,125402,964301,979769,577213,402556,903413,783126,314547,530373,373040,5200,33903,162411,438,807,516,1323,213,166,379,232,219,451,80,2672,100.0,51.0
560,KARNATAKA,Koppal,15.651253271028034,76.1617048598131,1389920,699926,272968,64681,689994,809085,468785,340300,654766,472182,223166,387974,266792,2135,15263,113995,317,577,394,971,124,106,230,149,182,331,42,1889,101.0,58.0
561,KARNATAKA,Gadag,15.507128256880746,75.64861302752298,1064570,537147,180066,111906,527423,700177,397178,302999,495722,306138,198064,310412,185310,3373,15625,104708,218,479,402,881,132,97,229,136,187,323,49,1699,102.0,66.0
562,KARNATAKA,Dharwad,15.343831376975173,75.13831264108359,1847023,937206,199707,283397,909817,1301664,711776,589888,784833,428556,347962,543776,241057,15013,49585,233604,289,801,937,1738,415,170,585,237,386,623,284,3519,103.0,70.0
564,KARNATAKA,Haveri,14.737582809224318,75.3961230607966,1597668,819128,315076,98488,778540,1085443,603793,481650,730066,383494,295937,490731,239335,2456,17819,155076,353,671,482,1153,153,127,280,178,224,402,52,2240,105.0,68.0
565,KARNATAKA,Bellary,15.074377548209377,76.47228471074374,2452595,1236954,371604,251876,1215641,1421621,813440,608181,1116880,787762,440374,703258,413622,9626,40190,291101,415,973,1010,1983,361,183,544,256,416,672,271,3886,102.0,58.0
566,KARNATAKA,Chitradurga,14.29102220394736,76.57821957236843,1659456,840843,349704,97644,818613,1087392,607188,480204,856587,452975,307257,513311,343276,5711,28897,174344,365,699,534,1233,158,127,285,177,253,430,60,2374,103.0,66.0
567,KARNATAKA,Davanagere,14.330414586709884,75.91723841166937,1945497,986400,354680,176011,959097,1308540,720637,587903,875207,467414,372671,585639,289568,7320,39416,256051,406,865,723,1588,233,169,402,237,337,574,91,3062,103.0,67.0
568,KARNATAKA,Shimoga,14.063845885634592,75.17882078103197,1752753,877415,352444,201662,875338,1263016,674938,588078,780598,355222,363835,534487,246111,8791,35207,259899,336,796,816,1612,271,150,421,209,340,549,200,3119,100.0,72.0
569,KARNATAKA,Udupi,13.450404228534568,74.72009990316337,1177361,562131,269817,115572,615230,926429,465704,460725,513241,204028,224814,335399,177842,9070,24817,173033,209,518,534,1052,236,73,309,103,167,270,259,2100,91.0,79.0
570,KARNATAKA,Chikmagalur,13.425288289676422,75.67626502311249,1137961,566622,311660,80766,571339,818345,438257,380088,565774,204371,238505,357889,207885,4510,18727,169969,239,538,521,1059,143,86,229,121,196,317,151,1996,99.0,72.0
571,KARNATAKA,Tumkur,13.592467760074973,77.02297966260545,2678980,1350594,685443,204799,1328386,1813391,1006024,807367,1354646,686274,562769,837512,517134,7971,41751,321848,613,1186,911,2097,289,220,509,309,423,732,116,4067,102.0,68.0
573,KARNATAKA,Mandya,12.574901806239744,76.81570098522172,1805769,905085,458867,103435,900684,1149649,638668,510981,871408,504734,391033,575203,296205,3367,20265,236020,408,779,609,1388,156,134,290,188,300,488,53,2628,100.0,64.0
574,KARNATAKA,Hassan,12.945098749999998,76.11049549999997,1776421,883667,496103,132878,892754,1225256,668836,556420,903580,401227,400702,560452,343128,4851,23444,272295,390,773,665,1438,184,131,315,183,297,480,119,2743,99.0,69.0
576,KARNATAKA,Kodagu,12.39684468085106,75.79336595744688,554519,274608,181182,31792,279911,412877,215302,197575,278938,91352,113931,172100,106838,3308,10758,83016,116,255,239,494,75,36,111,50,81,131,90,942,98.0,74.0
577,KARNATAKA,Mysore,12.248100259403367,76.52881802853437,3001127,1511600,540596,380386,1489527,1962180,1063766,898414,1314268,747237,640868,921803,392465,28397,80086,441131,535,1222,1261,2483,525,237,762,330,537,867,349,4995,101.0,65.0
579,KARNATAKA,Gulbarga,17.070459515951594,76.87503850385033,2566326,1301755,400704,199303,1264571,1427368,828359,599009,1087028,883704,404767,680001,407027,9752,52483,222126,761,1552,1211,2763,409,306,715,428,554,982,157,5378,103.0,56.0
581,KARNATAKA,Kolar,13.312799881235172,78.01376947743476,1536401,776396,326567,151042,760005,1016219,564110,452109,717872,399089,309494,454048,263824,5051,27235,209698,477,1007,799,1806,206,193,399,271,394,665,41,3389,102.0,66.0
583,KARNATAKA,Bangalore Rural,12.936827087794448,77.47369314775169,990923,509172,231052,95410,481751,688749,385311,303438,459891,205062,214253,315499,144392,3729,17066,156967,164,380,368,748,113,59,172,83,135,218,120,1422,106.0,70.0
585,GOA,North Goa,15.548723418714054,73.80667997909038,818008,416677,115859,209230,401331,663060,351738,311322,327658,99538,173951,239125,88533,23440,56266,146307,122,424,476,900,151,177,328,172,204,376,351,2078,104.0,81.0
586,GOA,South Goa,15.195278658183785,73.941792596877,640537,322463,88620,162873,318074,502427,264085,238342,249590,88577,138810,180411,69179,17624,44299,115535,87,314,375,689,122,148,270,143,164,307,294,1646,101.0,78.0
588,KERALA,Kasaragod,12.33310309912974,75.07768497134369,1307375,628613,251641,166164,678762,1037492,516476,521016,462998,212905,237670,325095,137903,10378,32484,179664,305,607,581,1188,126,183,309,78,80,158,28,1988,93.0,79.0
589,KERALA,Kannur,11.941523076923056,75.35209891725934,2523003,1181446,306288,566191,1341557,2138434,1012956,1125478,824116,279352,511167,609377,214739,32653,83940,423337,536,1272,1292,2564,259,373,632,281,370,651,49,4432,88.0,85.0
590,KERALA,Wayanad,11.715277464788736,76.07587007042254,817420,401684,266183,11805,415736,645585,328136,317449,340077,131211,149864,228639,111438,4712,15944,109972,234,385,260,645,94,98,192,6,9,15,9,1095,97.0,79.0
591,KERALA,Kozhikode,11.392924270557026,75.71158720159153,3086293,1470942,323793,666543,1615351,2615443,1266939,1348504,948981,335520,641660,752333,196648,36791,107602,490719,770,1476,1070,2546,354,307,661,208,338,546,71,4594,91.0,85.0
592,KERALA,Malappuram,10.97329875666072,75.93910775606876,4112920,1960328,634543,522586,2152592,3311315,1597404,1713911,1062424,622345,730119,898157,164267,27909,119918,485406,1156,1776,892,2668,480,265,745,73,111,184,83,4838,91.0,81.0
593,KERALA,Palakkad,10.784926903553291,76.49980490693744,2809934,1359478,665899,228442,1450456,2239492,1122600,1116892,1042340,439934,587583,746121,296219,27162,69440,447169,692,1253,1078,2331,294,384,678,60,90,150,78,3929,94.0,80.0
594,KERALA,Thrissur,10.458932647907687,76.12321940836945,3121200,1480763,336748,715119,1640437,2678548,1282261,1396287,1095727,307665,721625,789511,306216,56148,132774,616644,622,1548,1722,3270,449,397,846,438,247,685,189,5612,90.0,86.0
595,KERALA,Ernakulam,10.004879301987431,76.26957729035381,3282388,1619557,369694,804997,1662831,2855676,1425723,1429953,1249343,268315,771287,913249,336094,88737,184167,696129,654,1594,1933,3527,466,452,918,384,398,782,392,6274,97.0,87.0
596,KERALA,Idukki,9.80480963855423,77.04586641566264,1108974,552808,391610,20823,556166,923010,471881,451129,516363,126589,244844,331710,184653,8250,24863,207519,329,508,265,773,138,92,230,11,16,27,16,1374,99.0,83.0
597,KERALA,Kottayam,9.643701174068417,76.46059673302705,1974551,968289,481967,196194,1006262,1749798,861592,888206,735735,134393,464039,530322,205413,37849,83999,406922,481,918,893,1811,241,276,517,105,70,175,88,3071,96.0,89.0
598,KERALA,Alappuzha,9.542602965599087,76.38010796263319,2127789,1013142,331419,392117,1114647,1852797,890552,962245,804471,163991,507913,536738,267733,28842,71593,425707,516,1012,940,1952,226,283,509,109,167,276,116,3368,91.0,87.0
600,KERALA,Kollam,8.929388820570157,76.6360775852431,2635375,1246968,523715,401415,1388407,2240273,1074345,1165928,912025,231286,630767,644362,267663,31542,83133,525754,667,1228,1056,2284,295,351,646,84,126,210,103,3910,90.0,85.0
601,KERALA,Thiruvananthapuram,8.537101759082221,76.88711502868073,3301427,1581678,559293,609824,1719749,2785408,1354857,1430551,1231669,309042,783872,864101,367568,71621,155321,658734,766,1611,1689,3300,424,491,915,214,302,516,273,5770,92.0,84.0
602,TAMIL NADU,Thiruvallur,13.275858101752885,80.19724702864492,3728104,1876062,387237,732196,1852042,2791721,1495711,1296010,1538054,610048,909400,1103563,434491,75634,174279,857364,539,1940,1732,3672,1137,455,1592,472,876,1348,580,7731,101.0,75.0
603,TAMIL NADU,Chennai,13.058098905608748,80.28139151846806,4646732,2335844,0,1314125,2310888,3776276,1968079,1808197,1817297,419065,1096334,1369302,447995,217368,355838,1055696,471,2117,3685,5802,1954,1866,3820,748,1214,1962,3686,15742,101.0,81.0
604,TAMIL NADU,Kancheepuram,12.496424756511884,80.08820360135913,3998252,2012958,438799,774705,1985294,3013382,1611461,1401921,1673814,678374,961161,1181308,492506,100322,200738,904619,541,1993,1965,3958,1138,560,1698,522,832,1354,797,8349,101.0,75.0
605,TAMIL NADU,Vellore,12.784882632293078,79.02643283582084,3936331,1961688,653499,486801,1974643,2773928,1504355,1269573,1689330,891430,865913,1123874,565456,20623,69912,797713,789,2455,1670,4125,1082,579,1661,340,777,1117,402,8092,99.0,70.0
606,TAMIL NADU,Tiruvannamalai,12.419318947368414,79.23265631578953,2464875,1235889,563102,147061,1228986,1626813,909803,717010,1238177,672427,549077,738995,499182,6445,27529,505170,545,1519,798,2317,483,324,807,118,271,389,131,4189,101.0,66.0
608,TAMIL NADU,Salem,11.629324202127655,78.2478257978723,3482056,1781571,572813,597539,1700485,2285562,1285107,1000455,1694160,955045,835377,1083797,610363,20660,63867,749932,642,2185,1727,3912,1197,523,1720,437,943,1380,515,8169,105.0,66.0
609,TAMIL NADU,Namakkal,11.33766638477801,78.14624841437633,1726601,869280,370357,257127,857321,1176131,653312,522819,898245,388418,441044,531463,366782,8960,31581,418420,309,1050,890,1940,506,241,747,220,358,578,249,3824,101.0,68.0
610,TAMIL NADU,Erode,11.267012155963302,77.42034334862392,2251744,1129868,411286,432398,1121876,1492662,828300,664362,1195773,608003,595211,732083,463690,18604,58861,557479,521,1933,1748,3681,1130,450,1580,513,933,1446,491,7719,101.0,66.0
612,TAMIL NADU,Dindigul,10.377801390820574,77.78011279554937,2159775,1080938,443818,269724,1078837,1481834,816180,665654,1105155,480681,500057,665469,439686,9155,38677,458486,421,1362,1000,2362,634,322,956,228,479,707,236,4682,100.0,69.0
613,TAMIL NADU,Karur,10.79532776617955,78.08749686847604,1064493,528184,212241,152420,536309,727044,401726,325318,543298,276930,264949,329034,214264,4915,17995,250010,199,628,485,1113,267,158,425,99,172,271,145,2151,98.0,68.0
615,TAMIL NADU,Perambalur,11.260137758112096,78.86034011799416,565223,282157,155413,33179,283066,375823,208011,167812,299726,109011,135751,162639,137087,1507,7745,125953,117,346,242,588,87,79,166,40,36,76,31,979,100.0,66.0
616,TAMIL NADU,Ariyalur,11.190514836795256,79.22249643916912,754894,374703,223955,30322,380191,480604,269582,211022,359851,233438,177502,212547,147304,1749,8371,165150,196,518,234,752,121,108,229,19,44,63,18,1258,99.0,64.0
617,TAMIL NADU,Cuddalore,11.57587300613498,79.63002365371497,2605914,1311697,497429,260780,1294217,1815281,1000322,814959,1169880,634041,598412,749633,420247,15396,50938,555029,519,1580,1097,2677,683,405,1088,200,432,632,385,5300,101.0,70.0
618,TAMIL NADU,Nagapattinam,10.789468161718286,79.79437299431483,1616450,798127,399016,118724,818323,1213008,640916,572092,671994,253572,381940,461174,210820,5585,19692,362211,334,992,697,1689,313,253,566,110,157,267,170,3026,98.0,75.0
619,TAMIL NADU,Thiruvarur,10.368927409395978,79.60322893959727,1264277,626693,321331,86848,637584,946471,503085,443386,540168,175564,303114,369853,170315,4416,15535,287260,271,781,497,1278,240,193,433,65,117,182,108,2272,98.0,75.0
620,TAMIL NADU,Thanjavur,10.387692255892237,79.3194869107745,2405890,1182416,479070,274302,1223474,1790998,944264,846734,974079,461123,555582,680483,293596,13495,42912,522490,481,1474,1064,2538,603,389,992,187,370,557,348,4914,97.0,74.0
621,TAMIL NADU,Pudukkottai,10.130514816433578,79.05444484265728,1618345,803188,399712,104229,815157,1110545,608776,501769,761693,447346,354493,471099,290594,4494,18272,324444,349,1005,636,1641,282,229,511,86,132,218,92,2812,99.0,69.0
622,TAMIL NADU,Sivaganga,9.960306580645158,78.56535729032255,1339101,668672,309224,143193,670429,959744,526304,433440,620171,311112,314270,391305,228866,5773,24456,304124,248,757,578,1335,258,205,463,103,137,240,169,2456,100.0,72.0
623,TAMIL NADU,Madurai,9.904313833333331,78.01366033333332,3038252,1526475,417718,592723,1511777,2273430,1223810,1049620,1354632,449125,754141,902704,451928,34097,95311,708942,458,1632,1526,3158,980,502,1482,372,710,1082,738,6917,101.0,75.0
624,TAMIL NADU,Theni,9.924066666666668,77.43458833333332,1245899,625683,189328,221295,620216,870080,479403,390677,591642,270738,312310,368900,222742,4667,18830,291879,218,734,506,1240,401,169,570,153,367,520,94,2642,101.0,70.0
625,TAMIL NADU,Virudhunagar,9.468872195892564,77.87641469194315,1942288,967709,363782,370942,974579,1398788,760375,638413,950158,403246,505950,579111,371047,10219,37357,457317,364,1185,921,2106,595,298,893,199,416,615,321,4300,99.0,72.0
626,TAMIL NADU,Ramanathapuram,9.31286995153476,78.99185362412462,1353445,682658,290478,126761,670787,978946,536487,442459,602977,107292,291400,392751,210226,5172,22379,284169,265,778,504,1282,268,185,453,75,151,226,112,2340,102.0,72.0
629,TAMIL NADU,Kanniyakumari,8.183466300191206,77.32053064053538,1870374,926345,104253,493788,944029,1548738,780541,768197,679620,210901,465692,524629,154991,15673,52943,438938,275,1048,990,2038,662,246,908,291,534,825,332,4377,98.0,83.0
630,TAMIL NADU,Dharmapuri,12.300141200000006,78.11509813333339,1506843,774303,396819,91107,732540,917709,527599,390110,751170,512824,337972,446057,305113,3651,18927,310765,380,969,370,1339,255,180,435,42,92,134,76,2364,106.0,61.0
632,TAMIL NADU,Coimbatore,10.871376995940452,77.07619012178621,3458045,1729297,284795,884957,1728748,2635907,1394790,1241117,1567950,519919,896325,1083125,484825,63273,149920,841918,725,2868,3206,6074,1958,1062,3020,847,1435,2282,1837,13938,100.0,76.0
634,PONDICHERRY,Yanam,16.707695652173904,82.26187304347832,55626,27301,0,15519,28325,39274,19919,19355,16760,14923,12859,14047,2713,207,597,7393,510,1993,2316,4309,1370,838,2208,576,978,1554,1446,10027,96.0,71.0
636,PONDICHERRY,Mahe,12.006420793787758,75.28275021570326,41816,19143,0,12110,22673,36470,16610,19860,11802,2993,7150,9093,2709,574,1484,6488,510,1993,2316,4309,1370,838,2208,576,978,1554,1446,10027,84.0,87.0
637,PONDICHERRY,Karaikal,10.876161726078813,79.82369793621002,200222,97809,35618,33715,102413,154916,79903,75013,68301,32717,47880,53139,15162,1868,4870,38869,407,1345,1063,2408,665,340,1005,246,483,729,341,4890,96.0,77.0
